Id_com2017,Surfbati,Surfparc,Surfcons,Maison,Appart,Pro,Divers,Cumul,Dens_cons
14001,13529,231634.29,149188.76,88,8,7,0,103,6.90401
14002,1046,33184.16,19010.65,7,0,0,0,7,3.68215
14003,1989,27863.04,21083.68,16,0,2,0,18,8.53741
14005,13341.25,297000.62,150828.41,89,2,4,0,95,6.29855
14006,7360,85240.55,76097.63,61,0,0,0,61,8.01602
14007,1073,24677.05,16500.67,6,0,0,0,6,3.63622
14009,12316,102865.35,85737.18,95,8,2,0,105,12.2467
14011,14731.5,299271.18,199825.53,83,0,4,0,87,4.3538
14012,1485,100231.13,28232.72,8,8,0,0,16,5.66718
14013,162,10906.5,3878.24,1,0,0,0,1,2.57849
14014,3894.63,35454.07,29871.59,29,5,3,0,37,12.3863
14015,5059.63,42078.6,42101.96,27,4,2,0,33,7.83811
14016,9070,227846.86,91733.9,28,1,9,0,38,4.14242
14019,2582,45165.47,45189.64,14,0,0,0,14,3.09806
14020,39114.63,304588.79,248558.38,208,17,38,0,263,10.581
14021,2321,16513.02,16524.46,17,2,3,1,23,13.9188
14022,6843.75,49838.98,49873.64,48,4,7,0,59,11.8299
14023,1016.63,15506.65,15518.06,8,0,0,0,8,5.15528
14024,11911.75,157876.29,149871.9,69,103,1,0,173,11.5432
14025,2230,29358.93,22360.45,8,0,1,0,9,4.02496
14026,10011.75,108682.99,99925.49,82,0,0,0,82,8.20611
14027,48031.38,562478.33,449443.26,347,64,12,2,425,9.45614
14030,9169,57508.42,57536.63,76,14,0,0,90,15.6422
14032,5354,253946.15,89271.35,17,0,8,0,25,2.80045
14033,4384,275450.79,98871.82,25,0,3,0,28,2.83195
14034,2267.38,45820.72,32248.15,15,0,1,0,16,4.96152
14035,15579.63,163124.05,145525.76,118,6,5,0,129,8.86441
14036,2847,33168.12,33182.4,24,0,0,0,24,7.23275
14037,4459.63,78145.75,57167.12,29,0,0,0,29,5.07285
14038,10524.5,88890.64,76506.99,85,0,1,0,86,11.2408
14039,9543.88,101904.33,97006.92,87,0,0,0,87,8.96843
14040,2937,39766.43,39790.23,8,6,2,0,16,4.02109
14041,1430,131244.55,40523.21,8,0,0,0,8,1.97418
14042,5512.38,51838.17,49049.15,40,0,2,0,42,8.56284
14044,11628,92495.73,90606.85,95,3,0,0,98,10.816
14045,1910.25,199286.2,29444.72,9,0,0,0,9,3.05658
14046,13130.5,220423.66,118733.97,66,0,3,0,69,5.81131
14047,102245,486413.73,465453.32,306,634,111,4,1055,22.6661
14049,737,19238.84,11722.99,6,0,0,0,6,5.11815
14050,1116.25,24356.7,24366.72,11,0,0,0,11,4.51435
14053,684,20222.34,12468.92,4,0,0,0,4,3.20798
14054,2177,48524.53,43425.83,14,0,0,0,14,3.22389
14055,2341,463838.2,56740.49,10,0,0,0,10,1.76241
14057,10726,105311.34,64829.51,99,2,4,0,105,16.1963
14059,2922,28187.16,21715.99,17,20,1,0,38,17.4986
14060,23406.63,125198.2,125266.92,154,46,10,0,210,16.7642
14061,83616.38,2621945.96,1355878.76,508,14,46,2,570,4.20392
14062,4939,35729.59,35751.84,45,0,1,0,46,12.8665
14063,373,8819.93,8825.16,3,0,0,0,3,3.39937
14064,2352.5,32395.58,20454.41,16,0,0,0,16,7.82227
14066,17334.13,155228.27,132907.31,169,2,2,0,173,13.0166
14068,55893,322237.34,313676.83,247,3,28,0,278,8.86262
14069,14036,151018.71,140843.42,123,0,4,0,127,9.01711
14070,2838,110762.34,50161.14,13,0,3,0,16,3.18972
14076,60911,678425.48,554634.64,189,374,25,3,591,10.6557
14077,6526,286211.08,125180.62,48,4,7,0,59,4.71319
14078,5331,80526.74,73712.8,45,0,0,0,45,6.10477
14079,18763.63,268209.25,134323.32,93,205,8,0,306,22.7809
14080,669.125,23262.03,23262.61,3,0,0,0,3,1.28962
14082,3748,53482.12,51225.08,30,0,2,0,32,6.24694
14083,5066.25,170448.81,92078.04,20,2,3,0,25,2.71509
14084,2781.13,40693.55,37974.37,22,0,0,0,22,5.79338
14085,8177,425926.63,191891.99,50,1,4,0,55,2.8662
14086,5543,212786.58,80571.69,26,0,2,0,28,3.47517
14087,929,26425.92,23353.55,5,0,1,0,6,2.5692
14088,2698,32872.89,32876.29,21,0,1,0,22,6.69175
14089,1448,15451.49,15456.76,11,0,0,0,11,7.11663
14090,6096,187974.18,50174.27,57,7,1,0,65,12.9548
14091,396,15027.81,15036.72,2,0,0,0,2,1.33008
14092,35007.5,232517.92,206560.14,152,57,44,0,253,12.2482
14093,3674,143444.89,48822.39,86,0,0,0,86,17.6149
14096,1593,44649.5,26435.04,10,0,0,0,10,3.78286
14097,3033,25521.65,25527.01,25,0,0,0,25,9.79355
14098,59500.25,476988.17,406252.82,353,33,46,0,432,10.6338
14100,16739,169965.48,146604.66,114,4,17,2,137,9.34486
14101,48779.5,170806.17,170882.35,40,194,47,1,282,16.5026
14102,13127.13,217299.74,155991.44,64,2,7,1,74,4.74385
14103,5038,54628.34,49841.59,43,0,1,0,44,8.82797
14104,1974,157784.24,58369.56,15,0,1,0,16,2.74116
14106,4052,46356,31193.05,20,0,2,0,22,7.05285
14107,1553.25,22873,22887.03,12,0,0,0,12,5.24314
14110,667,16494.77,16504.13,5,0,0,0,5,3.02954
14111,2373.38,31870.18,31884.92,21,0,0,0,21,6.58618
14116,1456,15814.01,15817.56,6,0,2,0,8,5.05767
14117,39650,376856.33,294831.5,130,350,102,2,584,19.8079
14118,235024,869906.49,735739.64,225,3064,628,14,3931,53.4292
14119,48294,375757.54,277095.51,85,28,13,1,127,4.58326
14120,16044,424009.24,266197.85,99,1,9,0,109,4.0947
14121,3250,78998.21,79031.54,21,0,1,0,22,2.7837
14122,1888,70305.1,29958.98,16,0,0,0,16,5.34064
14123,23535,150296.19,150375.71,180,2,2,0,184,12.236
14124,10437,150855.23,103193.62,33,4,2,0,39,3.7793
14125,11203.75,68628.03,62472.9,70,6,2,0,78,12.4854
14126,9267,289582.13,160990.72,50,5,7,0,62,3.85115
14127,4406,125785.04,70224.37,31,0,0,0,31,4.41442
14130,1842,54556.09,28856.94,12,0,0,0,12,4.15844
14131,727,27759.88,11853.99,4,0,0,0,4,3.37439
14132,2157,42184.45,34381.22,16,0,0,0,16,4.6537
14134,1220,26676.1,26686.2,9,0,0,0,9,3.37253
14135,3289.38,35620.63,27413.92,12,0,3,0,15,5.47167
14136,18,664.425,664.895,0,0,0,0,0,0
14137,73482,313606.41,310800.04,120,67,138,3,328,10.5534
14138,2391,35340.7,29011.04,10,0,0,0,10,3.44696
14140,2235.63,37962.92,37980.97,17,0,0,0,17,4.47593
14141,2995,323890.42,58654.99,11,2,0,0,13,2.21635
14143,22945.5,313581.62,283383.13,132,8,67,0,207,7.3046
14145,3269,43294.64,43304.98,33,0,0,0,33,7.62037
14146,1079,21449.05,21451.14,5,0,1,0,6,2.79705
14147,1913.75,65584.55,47325.43,16,0,0,0,16,3.38085
14149,5870,49961.58,49977.27,52,0,0,0,52,10.4047
14150,1924,15264.12,15266.37,8,2,1,0,11,7.20538
14159,1624,50759.01,26612.01,11,0,1,0,12,4.50924
14160,528,5484.89,5486.36,2,0,1,0,3,5.46811
14161,5553,382752.67,116945.47,32,0,2,0,34,2.90734
14162,5604.88,117853.68,93901.58,43,0,1,0,44,4.68576
14163,4328,81644.6,60335.74,32,0,0,0,32,5.30366
14165,5070,726565.64,66337.35,30,0,2,1,33,4.97457
14166,17317,103042.27,92763.54,133,23,4,0,160,17.2482
14167,109600,731586.36,503601.49,170,499,71,0,740,14.6942
14168,1226.38,23387.28,17282.3,9,0,0,0,9,5.20764
14169,296,442.424,442.701,1,0,1,0,2,45.1772
14171,2199.88,68979.92,30247.31,12,0,0,0,12,3.96729
14172,3263,32584.33,31753.23,39,0,1,0,40,12.5971
14173,4843,196889.06,74354.92,31,0,2,0,33,4.43817
14174,45070.88,789047.04,508158.57,183,6,27,4,220,4.32936
14175,3148.25,34175.16,34192.87,22,0,0,0,22,6.43409
14177,8901,143262.57,100360.19,83,0,3,0,86,8.56913
14179,1770,70022.77,49591.12,16,0,0,0,16,3.22638
14180,1378,27085.34,22204.66,8,0,1,0,9,4.0532
14181,35100.25,186233.45,186312.1,290,54,21,1,366,19.6445
14182,2580,31026.89,27459.34,14,0,0,0,14,5.09845
14183,468.25,8598.01,8598.09,4,0,0,0,4,4.6522
14184,1434,20260.11,20272.13,8,0,1,0,9,4.43959
14185,1992.5,111207.23,45820.44,12,0,0,0,12,2.61892
14191,36644,286662.48,225436.55,101,267,275,0,643,28.5224
14193,3424,124952.86,54764.48,21,0,0,0,21,3.8346
14194,7658,243627.95,168900.03,53,0,1,0,54,3.19716
14195,1912,38065.32,25573.08,6,0,0,0,6,2.34622
14196,1291,16088.13,16098.71,5,0,5,0,10,6.21168
14197,8714,63788.85,59246.81,61,0,1,0,62,10.4647
14198,2899,83743.96,69725.1,19,0,1,0,20,2.86841
14200,21534.75,155889.12,155983.47,181,4,8,0,193,12.3731
14202,10842,88139.24,76991.38,8,0,28,0,36,4.67585
14203,4085,151273.28,38421.99,7,0,0,0,7,1.82187
14204,2025,29193.05,29215.38,12,0,1,0,13,4.44971
14205,2053.88,20816.78,20826.65,14,0,1,0,15,7.20231
14206,2078.25,32897.28,32896.65,12,0,0,0,12,3.64779
14207,8997.88,113717.4,102921.77,71,0,2,0,73,7.09277
14209,6443,118700.72,77313.69,38,0,3,0,41,5.30307
14211,2463,86494.34,49323.99,21,0,0,0,21,4.25756
14214,2686,77309.52,35406.73,12,3,1,0,16,4.51891
14215,14711.88,92716.36,92759.55,109,0,5,0,114,12.2898
14216,2169,19417.83,19418.67,18,0,0,0,18,9.26943
14218,13318,174486.94,145623.71,160,50,3,0,213,14.6267
14220,31142,150795.52,143442.12,105,514,44,2,665,46.3602
14221,45184,228847.48,220686.35,172,80,24,0,276,12.5064
14223,454.875,21463.39,9292.46,5,0,0,0,5,5.38071
14224,303,417.461,417.759,2,0,1,0,3,71.8118
14225,37010,305488.03,204729.29,178,306,31,1,516,25.204
14226,2933.63,56674.16,46622.63,27,0,0,0,27,5.79118
14227,2779.63,85640.69,44182.61,13,0,1,0,14,3.16867
14228,62062,293184.41,287860.95,207,216,78,0,501,17.4042
14229,11381,83109.32,83153.63,72,1,9,1,83,9.98152
14230,1247,54202.82,28546.9,10,0,0,0,10,3.50301
14231,5950,228347.22,85524.24,24,0,0,0,24,2.80622
14232,1298,74333.84,13160.48,5,0,0,0,5,3.79925
14236,7676,77750.18,77791,32,0,1,0,33,4.24214
14237,7703,66195.34,65862.93,64,0,0,0,64,9.71715
14238,1705,69136.23,28037.91,9,3,0,0,12,4.27992
14239,192,588.793,589.242,2,0,0,0,2,33.9419
14240,6349,127678.15,87465.71,52,0,1,0,53,6.05952
14241,5153.5,138040.66,88781.11,34,1,2,0,37,4.16755
14242,5098.75,28186.99,28201.4,45,0,0,0,45,15.9567
14243,17689,232053.35,176771.63,48,82,8,1,139,7.86325
14244,3879,93172.38,60424.9,29,0,0,0,29,4.79935
14245,2130,37509.87,24139.81,14,0,2,0,16,6.62806
14246,8629,72771.73,72807.97,74,0,0,0,74,10.1637
14248,1929,18555.43,18558.81,10,0,1,0,11,5.9271
14249,14386.75,116403.96,107078.27,131,11,3,0,145,13.5415
14250,2768.75,77087.03,52829.6,14,0,0,0,14,2.65003
14251,7038.63,113131.33,96030.43,54,0,1,0,55,5.72735
14252,1958,59378.19,25934.76,13,0,0,0,13,5.01258
14254,20845,125395.72,125445.38,169,28,11,0,208,16.5809
14256,3531,40034.21,40061.06,32,0,0,0,32,7.98781
14257,29886.88,183406.9,183467.09,167,19,112,1,299,16.2972
14258,98882,485498.01,473381.46,276,335,62,1,674,14.238
14260,3057,148742.97,81558.79,21,0,0,0,21,2.57483
14261,6749,290617.75,166669.3,40,0,2,0,42,2.51996
14266,12998.88,78091.81,78118.97,96,7,2,0,105,13.441
14269,1649,68700.99,43060.18,8,0,0,0,8,1.85786
14270,3163,65401.25,56673.57,19,0,1,0,20,3.52898
14271,64055.63,300550.44,280129.11,107,258,55,2,422,15.0645
14272,247.5,2817.94,2819.57,2,0,0,0,2,7.09329
14273,788,73775.97,26952.37,5,0,1,0,6,2.22615
14274,20649.75,130918.09,125237.2,132,30,5,0,167,13.3347
14275,2021.25,12462.55,12470.06,22,0,0,0,22,17.6423
14276,2792,38027.41,34424.03,24,0,0,0,24,6.97187
14277,13689.63,90131.3,88236.34,128,12,1,0,141,15.9798
14278,13958,120743.84,114459.26,101,0,4,0,105,9.17357
14280,3238,260129.2,76709.46,21,0,1,0,22,2.86796
14281,8702,182294.16,138168.42,46,0,4,0,50,3.61877
14282,1630,32949.03,32961.83,8,0,1,0,9,2.73043
14283,2587.5,90009.73,25850.85,20,0,0,0,20,7.73669
14284,3007.63,31646.77,28579.25,4,0,0,0,4,1.39962
14285,870,18225.69,18234.5,5,0,0,0,5,2.74205
14286,6250.25,255650.6,175980.72,42,0,0,0,42,2.38663
14287,20911.25,137894.44,137946.99,184,0,6,0,190,13.7734
14288,5283,73433.83,59522.24,32,0,1,0,33,5.54415
14289,6660,104511.85,95064.3,54,0,1,0,55,5.78556
14290,8067.13,72852.64,65581.65,70,0,0,0,70,10.6737
14291,2589.5,27121.46,27126.38,19,0,1,0,20,7.3729
14293,3377,196449.28,85954.97,19,0,2,0,21,2.44314
14294,8448.75,67002.33,67024.1,66,0,4,0,70,10.444
14297,10528,75939.42,73624.51,101,0,0,0,101,13.7183
14298,1460,33702.71,20507.17,8,0,2,0,10,4.87634
14299,9215,341629.08,134064.81,62,2,1,0,65,4.8484
14300,1812,87443.85,14076.47,3,0,0,0,3,2.13122
14301,39158.75,238299.18,218850.18,299,5,19,0,323,14.759
14302,1805,146236.92,26945.75,9,0,0,0,9,3.34004
14303,21946.88,310757.86,160853.93,48,0,6,0,54,3.35708
14304,15273,296706.69,188006.81,73,106,4,0,183,9.73369
14305,13142,368542.65,199931.83,65,0,2,0,67,3.35114
14306,4738,44063.01,44088.21,29,0,1,0,30,6.80454
14307,1306,11849.87,11852.52,10,0,0,0,10,8.43703
14308,1536,19669.12,19679.2,9,0,0,0,9,4.57336
14309,2916,36986.78,24062.6,23,0,3,0,26,10.8051
14310,6739,70157.64,57375.94,60,0,0,0,60,10.4573
14311,4861,47888.75,41762.43,29,4,0,0,33,7.90184
14312,20222,181828.88,156643.91,157,152,9,1,319,20.3647
14316,4532,120814.76,94379.6,25,0,1,0,26,2.75483
14318,8902,75592.29,75643.98,12,0,2,1,15,1.98297
14319,34073,184693.21,156709.86,83,0,27,0,110,7.01934
14320,807,11001.41,11003.9,5,0,0,0,5,4.54385
14322,3799,98333.23,62335.92,21,0,0,0,21,3.36884
14325,25995,139606.87,136987.73,245,64,9,0,318,23.2138
14326,24392,341231.42,252247.62,52,0,17,0,69,2.73541
14327,129055,568572.59,467127.08,95,1135,212,1,1443,30.891
14328,8655,60391.69,59911.6,45,16,1,0,62,10.3486
14329,1115.25,40072.5,27336.3,10,0,0,0,10,3.65814
14332,6258.25,132650.71,75325.33,49,0,2,0,51,6.77063
14333,145338,953291.56,683356.59,371,474,114,3,962,14.0776
14334,3366,83183.3,64634.07,26,0,0,0,26,4.02265
14335,5160,289820.62,95828.23,13,0,1,0,14,1.46095
14336,4215.5,57139.28,48701.95,22,0,2,0,24,4.92793
14337,4952,89175.51,57144.69,23,0,0,0,23,4.02487
14338,36452,332491.41,326666.27,355,274,17,2,648,19.8368
14339,2571.13,16191.02,16197.04,25,0,0,0,25,15.4349
14341,152871,756142.53,731891.8,412,241,97,3,753,10.2884
14342,30248.38,415246.99,275983.12,92,47,19,2,160,5.79746
14343,1152,74880.28,48552.39,2,0,1,0,3,0.617889
14344,784,39082.08,17837.62,4,0,1,0,5,2.80306
14345,2039,25948.63,25952.19,8,0,0,0,8,3.08259
14346,4190,180603.35,57630.57,29,0,1,0,30,5.20557
14347,10490,225980.91,174314.28,66,0,3,1,70,4.01574
14348,855,19148.7,19156.43,5,0,2,0,7,3.65412
14349,21482,165584.13,152568.9,203,4,4,0,211,13.8298
14352,7276,184698.45,126380.71,44,0,0,0,44,3.48154
14353,4665.13,62633.52,48229.38,34,0,0,0,34,7.04964
14354,9427,79485.07,79537.84,62,16,3,1,82,10.3096
14355,5958,83999.59,68704.86,48,0,0,0,48,6.98641
14357,4659.13,192155.74,98967.5,25,0,2,0,27,2.72817
14358,1023,58360.1,22447.76,6,0,0,0,6,2.67287
14360,2716,57112.88,35697.1,20,0,0,0,20,5.6027
14362,773,228551.37,22408.37,6,0,1,0,7,3.12383
14364,2293.13,32051.21,32065.35,9,0,0,0,9,2.80677
14365,9971,58804.94,52450.1,81,64,9,0,154,29.3612
14366,166603.25,891546.89,715909.31,294,762,222,10,1288,17.9911
14367,2715.75,102616.23,52564.3,21,0,0,0,21,3.99511
14368,2320,97894.65,67261.11,16,0,3,0,19,2.82481
14369,3882.13,40469.22,40485.65,20,0,4,0,24,5.92803
14370,24877,278106.26,220793.09,160,23,15,1,199,9.01296
14371,58672,2159772.91,961980.83,271,15,33,1,320,3.32647
14374,729,23922.18,13282.53,5,0,0,0,5,3.76434
14375,1004,18231.51,18230.83,10,0,0,0,10,5.48521
14377,4583,61632.18,54005.65,29,0,2,0,31,5.74014
14378,3518,51381.7,41680.9,21,0,1,0,22,5.2782
14379,2384.75,45629.04,44661.77,15,0,0,0,15,3.35858
14380,1588.38,41302.29,27145.6,11,0,1,0,12,4.42061
14381,271.625,1006.86,1006.95,3,0,0,0,3,29.793
14383,38727,267791.55,166856.64,152,217,46,0,415,24.8717
14384,24626,162159.22,125826.06,125,46,117,0,288,22.8887
14385,1445,13560.57,13569.29,9,0,0,0,9,6.63262
14389,1820,110451.22,69602.58,8,0,8,0,16,2.29877
14390,696,12068.93,12072.07,6,0,0,0,6,4.97015
14391,3523.75,51091.72,46272.92,25,0,3,0,28,6.05106
14393,3101,47586.06,35220.29,22,0,1,0,23,6.53033
14394,2690,41781.92,24544.44,16,0,0,1,17,6.92621
14396,15183,104651.93,104690.66,131,5,0,0,136,12.9907
14397,3613,61674.91,52885.79,29,0,0,0,29,5.48352
14398,6560,345882.16,136967.42,33,0,0,0,33,2.40933
14399,1562,65693.97,42952.74,10,0,0,0,10,2.32814
14400,1728,28079.18,28096.36,14,0,0,0,14,4.98285
14401,1220,13178.31,13187.43,9,0,0,0,9,6.82468
14402,931,12127.98,12127.81,8,0,0,0,8,6.59641
14403,26409,335782.45,188948.89,47,9,10,0,66,3.49301
14404,551,13837.91,5437.61,5,0,0,0,5,9.19521
14405,2237,57902.48,46006.88,14,0,0,0,14,3.04302
14406,11549.13,120096.27,120163.41,84,0,1,0,85,7.0737
14407,21738.5,190555.7,153363.53,149,61,2,0,212,13.8234
14408,14771,169956.53,107855.63,134,10,1,1,146,13.5366
14409,29399,199219.67,178551.31,168,244,14,1,427,23.9147
14410,12452.5,286434.48,139349.65,96,0,5,0,101,7.24796
14411,5572,70993.5,56744.02,17,0,1,0,18,3.17214
14412,899,13523.07,13526.34,8,0,0,0,8,5.91439
14419,1621,87320.45,31366.25,8,0,0,0,8,2.55051
14421,5729,150840.49,83834.99,47,0,0,0,47,5.60625
14424,2231,50926.66,38902.59,15,0,0,0,15,3.85578
14425,1095,58684.59,31986.67,8,0,0,0,8,2.50104
14426,1412,44236.74,37812.3,11,0,1,0,12,3.17357
14427,689,8523.95,8523.44,5,0,0,0,5,5.86617
14430,1246,15969.48,15980.42,7,0,1,0,8,5.00613
14431,70719.38,1410894.14,807359.68,460,93,44,0,597,7.39447
14435,788,23455.36,15752.6,7,0,0,0,7,4.44371
14436,9093,73704.27,73746.34,73,0,0,0,73,9.8988
14437,118916,591110.05,491121.37,110,421,103,7,641,13.0518
14438,2672.25,19322.36,19329.89,24,0,0,0,24,12.416
14439,325,15455.66,10223.37,4,0,0,0,4,3.9126
14445,1314,32127.03,25285.98,7,0,1,0,8,3.16381
14446,318,3592.14,3592.98,2,0,0,0,2,5.56642
14449,3033,49975.24,46992.11,16,0,1,0,17,3.61763
14452,5174,55770.76,56148.26,33,0,1,0,34,6.0554
14453,4663,152390.29,61697.17,36,0,0,0,36,5.83495
14454,24796.88,150047.57,144653.31,65,0,31,0,96,6.63656
14455,2189,24802.55,24806.35,17,0,0,0,17,6.85308
14456,51162,432579.5,394186.98,293,16,32,0,341,8.65072
14457,129,678.822,678.831,2,0,0,0,2,29.4624
14458,2257.13,86735.34,47958.59,15,0,1,0,16,3.33621
14460,15155,310312.97,231692.3,99,1,5,0,105,4.53187
14461,3242,135146.8,34462.62,21,0,1,0,22,6.38373
14465,12336,116168.17,116231.36,41,0,16,0,57,4.90401
14466,2645.25,124666.78,42295.95,21,0,1,0,22,5.20144
14467,3812,80052.12,50858.56,32,0,0,0,32,6.29196
14468,4370,83049.86,46240.88,34,0,2,0,36,7.78532
14469,145,2890.11,2890.2,1,0,0,0,1,3.45996
14473,1120,44841.34,6642.81,1,0,1,0,2,3.01078
14474,815,14368.71,14374.27,5,0,0,0,5,3.47844
14475,13612.13,153393.56,143192.42,101,8,3,0,112,7.82164
14476,938.125,7974.71,7975.69,7,0,0,0,7,8.77667
14478,10411,88525.47,85794.63,22,22,15,0,59,6.87689
14480,3388,34694.66,34718.43,28,0,1,0,29,8.35291
14482,1466,24966.86,20341.8,11,0,0,0,11,5.40759
14483,1245,24458.29,18272.94,9,0,0,0,9,4.92532
14484,3571,118216.83,87345.94,23,0,0,0,23,2.63321
14486,3988,67135.21,52265.47,29,0,2,0,31,5.93126
14487,5239,113030.82,52272.13,49,0,0,0,49,9.37402
14488,64862,306566.08,306747.96,409,209,70,0,688,22.4288
14491,2225,27426.89,27435.55,14,0,0,0,14,5.10287
14492,3821,130525.49,84430.17,20,0,2,0,22,2.6057
14494,6750,127531.66,42929.16,5,0,4,0,9,2.09648
14495,5409,49507.23,49535.52,37,1,0,0,38,7.67126
14496,161,2222.03,2222.15,1,0,0,0,1,4.50015
14497,2316,28456.31,28459.37,22,0,0,0,22,7.73032
14498,1185,21272.96,18414.62,8,0,0,0,8,4.34437
14499,6611,51827.56,51855.89,45,0,1,0,46,8.87074
14500,3075,133422.39,67011.76,19,0,1,0,20,2.98455
14501,850,85727.14,23302.69,7,0,0,0,7,3.00395
14502,732,16449.34,16449.34,5,0,1,0,6,3.64756
14504,13099,362084.34,285637.35,81,1,0,0,82,2.87077
14505,1904,56818.14,37395.31,12,0,0,0,12,3.20896
14506,2003,25496.98,18519.96,12,0,1,0,13,7.01945
14509,409,20044.45,10116.95,3,0,0,0,3,2.96532
14510,119,2105.58,2105.67,1,0,0,0,1,4.74909
14511,620,27535.31,10242.88,3,0,0,0,3,2.92887
14512,39,41.4592,41.4589,0,0,0,0,0,0
14513,4683,122376.23,64014.06,21,28,2,0,51,7.967
14514,52596,342137.32,308846.88,252,179,50,0,481,15.5741
14515,23545.38,191709.89,191844.17,255,132,9,3,399,20.7981
14516,21098,216715.82,125023.48,115,1,4,0,120,9.5982
14519,312,4091.04,4092.07,3,0,0,0,3,7.33125
14520,6825,210303.95,131234.15,50,0,4,0,54,4.11478
14522,3660,154245.42,84017.49,26,0,2,0,28,3.33264
14524,439,29335.64,13902.79,4,0,0,0,4,2.87712
14527,2139.38,105688.4,54013.98,17,0,1,0,18,3.33247
14528,4418,257033.79,117788.49,28,2,0,0,30,2.54694
14529,2200.13,45037.03,29116.95,17,0,1,0,18,6.18197
14530,11162,75606.21,73343.28,69,13,9,0,91,12.4074
14533,896,16629.02,16637.13,6,0,0,0,6,3.60639
14534,5620.25,136844.43,89721.07,36,7,1,0,44,4.90409
14535,3030,46307.72,28135.2,25,1,1,0,27,9.59652
14536,34149,345930.05,297145.35,233,285,10,0,528,17.7691
14538,7681,54974.75,54992.3,65,9,0,0,74,13.4564
14540,5340.25,160003.47,74145.03,11,0,2,0,13,1.75332
14541,2193,79854.83,38029.24,11,0,0,0,11,2.89251
14542,5906,50733.7,50759.82,40,4,1,0,45,8.86528
14543,38700.5,303792.75,272052.25,112,29,25,0,166,6.10177
14546,772,10448.71,10450.58,6,0,0,0,6,5.74131
14547,1811.25,34608.43,34629.68,14,0,0,0,14,4.04278
14550,454,45632.58,11658.97,6,0,0,0,6,5.14625
14552,4493,43628.97,43657.53,27,2,0,0,29,6.64261
14554,7450.13,50038.6,50053.11,8,0,7,0,15,2.99682
14555,4993.88,279149.46,102196.25,25,5,6,0,36,3.52263
14556,15843,80703.11,80732.12,63,13,29,0,105,13.006
14557,20912,128072.78,128161.66,59,235,20,0,314,24.5003
14558,5012,27502.29,27518.2,15,7,6,0,28,10.1751
14559,1174,33194.8,22993.71,7,0,0,0,7,3.04431
14562,26409,139054.72,139148.89,170,162,5,0,337,24.2187
14563,5802,264657.67,119739.96,34,0,3,0,37,3.09003
14565,2612,103364.9,29671.79,14,2,1,0,17,5.72935
14566,39397.63,219837.74,219946.43,187,0,117,0,304,13.8215
14569,2885,31694.22,31715,22,0,0,0,22,6.93678
14570,19020.25,588918.81,367002.18,141,4,5,0,150,4.08717
14571,2134,52884.8,33446.95,10,0,3,0,13,3.88675
14572,4821.25,83573.32,71734.46,35,0,2,0,37,5.15791
14574,16949,722713.17,170933.27,78,0,8,0,86,5.0312
14575,5079,208902.54,99958.22,22,0,3,0,25,2.50104
14576,4619,306633.68,105325.99,32,0,1,0,33,3.13313
14578,15916,677272.63,246502.42,73,0,36,1,110,4.46243
14579,12307,284782.77,223468.37,75,0,7,0,82,3.66942
14582,15054,258033.97,169801.5,37,9,1,0,47,2.76794
14586,1719,28533.85,25909.74,13,0,0,0,13,5.01742
14587,4105,19348.8,14246.49,22,68,1,0,91,63.8754
14588,3455.38,94871.44,73065.23,24,0,0,0,24,3.28474
14589,4675,42094.43,42102.16,46,0,1,0,47,11.1633
14590,248,3866.1,3867.61,2,0,0,0,2,5.17115
14591,8456,174027.94,113698.92,78,0,3,0,81,7.12408
14592,13656.88,139364.96,123002.27,98,0,2,0,100,8.12993
14593,9519.88,523963.93,236421.6,71,0,1,0,72,3.04541
14595,1490,31397.06,20325.87,13,0,0,0,13,6.39579
14598,1207,28379.37,27542.22,8,0,0,0,8,2.90463
14601,2995,60056.25,50726.17,8,0,2,0,10,1.97137
14602,3020,106780.88,39253.43,22,0,0,0,22,5.60461
14603,1528,15161.53,15165.17,10,0,1,0,11,7.25346
14604,1353,71566.32,31088.55,9,0,0,0,9,2.89496
14605,6531,58717.53,57025.07,50,0,2,1,53,9.29416
14606,1128,68715.05,28128.34,6,0,0,0,6,2.13308
14607,704,24258.29,8937.23,4,0,1,0,5,5.59457
14609,11444,246654.64,98436.63,65,0,6,0,71,7.21276
14610,21381.5,209058.18,195858.93,161,3,5,0,169,8.62866
14613,304,26452.2,10866.12,2,0,0,0,2,1.84058
14614,8755,115127.54,105771.24,30,0,4,0,34,3.21448
14619,2204,96463.32,45653.21,10,0,1,0,11,2.40947
14620,4833,188466.37,75064.55,32,0,0,0,32,4.263
14621,6851,192221.11,114709.84,36,1,1,0,38,3.31271
14622,1317,50340.05,30881.67,5,0,0,0,5,1.61908
14623,30237.75,181221.33,181283.85,263,0,2,0,265,14.618
14625,3890,230600.88,59684.26,14,4,2,0,20,3.35097
14626,5549,178402.43,94357.97,45,0,1,0,46,4.87505
14627,2851.63,49357.99,42766.95,14,0,1,0,15,3.50738
14630,17483,133425.54,129647.14,70,0,11,0,81,6.24773
14635,1517,21698.53,21699.75,11,0,1,0,12,5.53002
14637,2996.5,41761.68,33844.3,20,0,0,0,20,5.90942
14639,2858,55963.09,30932.48,6,0,0,0,6,1.93971
14640,2931,105714.16,40632.84,15,0,2,0,17,4.18381
14643,10047,207629.06,154123.02,63,0,4,0,67,4.34718
14644,4049,121843.36,98105.65,29,0,1,0,30,3.05793
14645,2745,129413.04,59715.89,16,0,0,0,16,2.67935
14646,3316.63,42597.99,33452.82,30,0,0,0,30,8.96785
14648,3219,137202.23,75348.06,24,0,1,0,25,3.31794
14649,3956.25,111926.69,46698.35,31,0,0,0,31,6.63835
14650,1024,22345.8,16680.59,8,1,0,0,9,5.39549
14651,3662,122758.62,46802.41,23,0,1,0,24,5.12794
14652,448,2450.85,2452.74,1,0,0,0,1,4.07708
14654,72038.5,1152557.88,706796.1,279,29,32,1,341,4.82459
14656,4868.25,46132.15,46135.65,39,1,3,0,43,9.32034
14657,2101,44266.37,31675.39,13,0,1,0,14,4.41984
14658,43362,1529595.05,660392.18,208,0,9,1,218,3.30107
14659,11968,89063.56,89087.08,117,0,1,1,119,13.3577
14660,813,30664.68,14276.44,5,0,0,1,6,4.20273
14661,927.5,22891.01,18030.78,9,0,0,0,9,4.99147
14663,44011,340831.59,229907.64,259,71,30,2,362,15.7455
14664,1518,28007.35,28017.07,11,0,0,0,11,3.92618
14665,2836.75,60899.4,29694.1,23,0,1,0,24,8.08241
14667,2838,77887.46,55270.6,13,0,0,0,13,2.35206
14668,5326.63,92958.66,78708.23,43,0,0,0,43,5.46322
14669,1700.75,50064.83,19615.18,10,0,1,0,11,5.6079
14672,8483,150889.29,134635.92,54,0,3,0,57,4.23364
14674,1452,16194.88,16198.39,14,0,0,0,14,8.64284
14675,15382,80047.2,77047.22,63,4,15,0,82,10.6428
14676,7809,64443.05,64483.17,69,0,1,0,70,10.8555
14677,1171,32636.78,19322.13,8,0,0,0,8,4.14033
14678,4315,44228.95,38102.1,15,0,4,0,19,4.9866
14679,7803,67303.32,67340.14,58,0,3,0,61,9.05849
14680,5252.25,153820.62,64055.67,11,1,3,0,15,2.34171
14681,1251,26975.64,19810.04,10,0,0,0,10,5.04795
14682,5913,199800.85,113856.88,32,0,1,0,33,2.89838
14684,1117.5,55264.37,16868.59,10,0,0,0,10,5.92818
14685,6464,51182.09,43881.85,50,0,0,0,50,11.3942
14687,1913,44812.79,34600.03,12,0,0,0,12,3.4682
14689,32584.75,668809.13,444600.75,202,11,15,0,228,5.1282
14691,2374.38,15511.79,15517.13,19,0,0,0,19,12.2445
14692,18760,144321.5,131060.21,144,22,6,0,172,13.1237
14694,5339,169461.59,132344.31,38,0,0,0,38,2.8713
14698,5980,69670.8,63005.83,26,0,3,0,29,4.60275
14699,36621,359881.17,223529.37,158,535,22,0,715,31.9868
14700,7787.25,212292.14,147733.06,49,0,5,0,54,3.65524
14701,10560,479351.88,151456.85,30,28,3,0,61,4.02755
14703,3192.13,214285.42,60799.66,26,0,0,0,26,4.27634
14705,981,10077.68,7687.18,3,0,0,0,3,3.9026
14706,1669,136140.41,31258.85,14,0,0,0,14,4.47873
14707,8399.88,56665.38,36384.64,17,1,2,0,20,5.49683
14708,935.75,9284.12,9286.7,7,0,0,0,7,7.53766
14709,3855,67693.11,46077.61,30,0,1,0,31,6.72778
14710,652,9518.86,9518.95,6,0,0,0,6,6.30322
14711,6432,111565.59,51989.14,45,0,3,0,48,9.2327
14712,40123.63,348167.79,264060.69,235,61,33,0,329,12.4593
14713,2887.5,73120.02,62463.56,23,0,0,0,23,3.68215
14714,3986,74698.41,64874.61,27,0,2,0,29,4.47016
14715,41691,249963.3,229885.43,172,362,37,0,571,24.8385
14716,986,21361.61,21371.83,8,0,0,0,8,3.74325
14719,6682.38,70667.73,61147.85,61,0,1,0,62,10.1394
14720,5653.38,87884.95,52172.66,40,0,1,0,41,7.85852
14721,5099.63,78840.92,64935.42,43,0,2,0,45,6.92996
14723,1631,120390.67,40420.67,13,0,1,0,14,3.46357
14724,14003.13,182027.06,99919.48,111,0,2,1,114,11.4092
14726,51005.13,1253616.11,831922.82,331,3,14,2,350,4.20712
14728,7801,113098.34,52357.32,48,0,4,0,52,9.93175
14731,2785.63,86739.34,57929.08,15,1,1,0,17,2.93462
14732,5366,147349.47,55847.01,13,1,1,0,15,2.68591
14733,1398,25600.63,17730.41,6,0,0,0,6,3.38402
14734,2585,32524.67,32537.5,19,0,0,0,19,5.83942
14735,3328,68284.12,44295.79,25,0,2,0,27,6.09539
14737,3488,45403.88,41265,25,0,2,0,27,6.54308
14738,41632.13,230960.58,207457.97,69,64,71,0,204,9.83332
14739,12447.88,78306.09,78360.48,110,16,0,0,126,16.0795
14740,15796,284508.86,182367.43,76,1,11,0,88,4.82542
14741,1636,26993.1,21717.67,12,0,0,0,12,5.52545
14742,192,3504.69,3505.01,2,0,0,0,2,5.70612
14743,1578,27004.69,27016.06,1,0,0,0,1,0.37015
14744,3703,52255.53,52287.08,27,0,0,0,27,5.1638
14745,4328,56784.36,56826.86,31,0,1,0,32,5.63114
14747,6421,47782.1,47798.27,51,7,0,0,58,12.1343
14748,1146,66552.71,27437.83,10,0,0,0,10,3.6446
14751,2731,44587.24,32744.08,17,0,2,0,19,5.80257
14752,39898,250324.51,250397.8,151,55,28,0,234,9.34513
14753,7661,93978.4,76778.85,67,0,1,0,68,8.85661
14754,31266,526663.41,249572.14,224,90,11,1,326,13.0624
14755,1628,34695.25,21741.88,10,7,1,0,18,8.27895
14756,1858.63,58292.5,40662.67,15,0,0,0,15,3.68889
14758,6401.5,51040.34,51067.85,43,0,0,0,43,8.42017
14759,2488,30103.46,30103.8,22,0,0,0,22,7.30805
14760,7057.5,114373.42,114410.82,54,0,1,0,55,4.80724
14761,8631,58383.39,54714.27,80,0,1,0,81,14.8042
14762,187019,2172039.2,1526395.58,588,193,257,7,1045,6.84619
14764,3754,47880.72,47879.68,20,17,2,0,39,8.14542
27001,1576.5,31915,31710.32,15,0,1,0,16,5.04568
27002,1477.13,27108,23724.5,17,0,1,0,18,7.58709
27003,5941,86979,55435.12,35,0,3,1,39,7.03525
27004,3601.38,41637.4,41637.43,32,0,0,0,32,7.68539
27005,7181.38,109426,108724.21,73,0,1,0,74,6.80621
27006,1186,33124.01,32205.47,10,0,0,0,10,3.10506
27008,16804.63,162296.1,162295.84,67,39,19,0,125,7.70198
27009,3169,61086,52769.29,46,0,0,0,46,8.71719
27010,836.625,13676,13588.31,9,0,1,0,10,7.35927
27011,5926.88,69733.86,67990.85,50,0,0,0,50,7.35393
27012,2320.25,30547,30351.08,19,0,0,0,19,6.26007
27013,2344,42884.47,36045.55,18,0,1,0,19,5.27111
27014,2957,37082.9,35381.66,23,1,0,0,24,6.78317
27015,10109.63,103403.23,103403.16,79,0,2,1,82,7.93013
27016,31188.51,272776,246777.2,201,262,33,2,498,20.1801
27017,8041,41938.09,41938.08,28,0,8,0,36,8.58408
27018,6564.13,116744,111235.81,70,0,1,0,71,6.38284
27019,1509.5,57665.81,25121.14,8,0,1,0,9,3.58264
27020,4046,175580.75,36265.7,29,0,3,0,32,8.82377
27021,3533.63,124060,97199.59,35,0,1,0,36,3.70372
27022,54677.13,337009.78,332891.99,315,79,21,2,417,12.5266
27023,6434,52887.42,52887.46,54,0,0,0,54,10.2104
27025,4282.75,48341,48030.99,44,0,0,0,44,9.16075
27026,1411,41355,25205.34,14,0,2,0,16,6.34786
27027,6129.75,46138.29,45357.28,27,0,4,0,31,6.83463
27028,1369.13,31480,25512.32,18,0,0,0,18,7.05541
27031,4924.88,40012.24,40012.22,37,0,0,0,37,9.24717
27032,9777.13,121569.06,115308.64,87,0,2,0,89,7.71842
27033,1281,13691.91,13691.93,10,0,0,0,10,7.30357
27034,3377.88,61910,53393.33,36,0,0,0,36,6.74242
27035,551.5,15374,9542.39,6,0,1,0,7,7.33569
27036,5196.63,70759.48,65832.09,43,3,1,0,47,7.13937
27037,15153.75,186781.5,186781.54,110,0,1,0,111,5.94277
27038,8932.75,125301.79,93466.7,31,0,61,0,92,9.84308
27039,3957.75,79815.11,76553.1,29,0,0,0,29,3.78822
27040,4193.5,87802,87238.88,47,0,1,0,48,5.50213
27042,74.375,2977,2957.9,1,0,0,0,1,3.38077
27043,4819,109667.8,88195.27,33,0,1,0,34,3.85508
27044,2225.13,21238.64,21238.72,18,0,0,0,18,8.47509
27045,4672,69067,68624.04,51,0,0,0,51,7.4318
27046,1156.13,30152,23272.74,12,0,1,0,13,5.58594
27047,2543.25,48702,48389.77,36,0,1,0,37,7.64625
27048,1270,38415,20313.89,10,0,1,0,11,5.41501
27049,37563.25,1275487.27,828996.04,345,0,18,0,363,4.37879
27050,1852.38,47021,42114.21,18,0,0,0,18,4.27409
27051,13325.13,171174,170076.29,144,32,11,0,187,10.9951
27052,2457,72393.36,46866.49,19,0,0,0,19,4.05407
27053,1609,11131.88,11131.84,6,0,3,0,9,8.08492
27054,4595.13,145447.45,73346.98,48,0,0,0,48,6.54424
27055,2340.5,38771.5,31394.9,23,0,0,0,23,7.32603
27056,89321.75,889840.64,543804.86,255,218,91,1,565,10.3898
27057,2279.38,97769.59,27938.12,15,0,1,0,16,5.72694
27059,207.5,2822,2803.9,3,0,0,0,3,10.6994
27061,1965.25,75575,41506.88,23,0,0,0,23,5.54125
27062,16412,325109.41,243631.11,115,6,4,0,125,5.13071
27063,1500.63,27094,26920.33,16,0,0,0,16,5.94346
27064,8507,136748.73,131771.23,72,2,1,0,75,5.69168
27065,57274,698586.26,528114.62,325,427,23,0,775,14.6748
27066,3175,56327,55965.82,34,0,0,0,34,6.07514
27067,9342.13,98750,98116.63,94,29,0,0,123,12.5361
27068,1076.88,16794,16686.35,12,0,0,0,12,7.19151
27069,6949.13,101850,90784.02,36,0,2,0,38,4.18576
27070,2326.75,38173,37928.2,24,0,0,1,25,6.5914
27071,1794.63,56651,42641.76,19,0,1,0,20,4.69024
27072,3476.88,51349,51019.69,31,2,1,0,34,6.66409
27073,6479.25,89745,89169.39,69,0,0,0,69,7.73808
27074,2607.25,63224.46,48012.92,20,0,1,0,21,4.37382
27075,1131.38,33885,29996.46,13,0,0,0,13,4.33384
27076,2943.13,121372.87,46550.44,21,0,1,0,22,4.72606
27077,6867.63,87084.63,59239.11,74,0,0,0,74,12.4917
27078,931.25,58004.24,16326.77,4,0,0,0,4,2.44996
27079,2720.38,97014,70401.57,30,0,1,0,31,4.40331
27081,1616.75,18074.06,18074.01,11,0,0,0,11,6.08609
27082,11368,66738.78,66738.9,58,56,12,0,126,18.8795
27083,2348.13,47393.89,43267.88,20,0,0,0,20,4.62237
27085,12077.75,207953.24,180763.25,96,0,1,0,97,5.36614
27089,6220.25,109727.62,84549.39,49,0,0,0,49,5.79543
27090,25096.13,239479.19,205797.13,144,6,8,0,158,7.67746
27091,10376.5,417168.84,125563.77,51,0,4,2,57,4.53953
27094,1790.63,132356,25539.21,15,0,0,0,15,5.87332
27095,9669.75,150250.96,119569.15,76,0,2,0,78,6.52342
27096,2228.88,85193,63499.13,25,0,0,0,25,3.93706
27097,2784.5,33734,33517.7,23,6,1,0,30,8.9505
27098,220,8685,8629.28,3,0,0,0,3,3.47654
27099,5757.5,76831.06,76830.92,53,0,0,1,54,7.02842
27100,35937,342655.22,273444.92,106,148,12,0,266,9.72774
27101,7120,178420.41,138176.45,53,0,0,0,53,3.83568
27102,10084.63,213601.59,149764.55,66,5,1,1,73,4.87432
27103,62189.25,527439.6,475218.09,261,79,44,1,385,8.10154
27104,3725.75,120235,47269.94,35,0,3,0,38,8.03894
27105,31965.25,546549.72,327086.52,156,47,27,1,231,7.06235
27106,3218.38,73167,65951.32,36,0,0,0,36,5.45857
27107,16771,257269.72,214304.12,108,5,8,0,121,5.64618
27108,10577.5,92856.4,85995.51,57,0,4,0,61,7.09339
27109,5346.88,64085.26,64085.29,43,0,0,0,43,6.70981
27110,8141.88,137969.54,118332.12,55,0,0,0,55,4.64793
27111,873.125,12212,12133.72,5,0,1,0,6,4.9449
27112,34149.5,600974.16,328078,154,93,22,0,269,8.19927
27113,712.25,40325,23637.43,7,0,0,0,7,2.9614
27114,4976.5,87218.01,75833.01,37,4,4,0,45,5.93409
27115,2013.13,26437.91,24230.96,12,0,1,1,14,5.77773
27116,22754,228232.37,207624.68,147,91,15,1,254,12.2336
27117,16921,176680.14,157189.45,29,40,11,0,80,5.0894
27118,4257.38,64626.04,64626.02,26,0,1,0,27,4.17788
27119,10671.88,111028.74,111028.93,62,6,7,0,75,6.755
27120,6707,67404.27,63706.12,45,0,1,0,46,7.22066
27123,3738.5,32245.08,32245.11,32,0,2,0,34,10.5442
27124,386.875,7211,7164.75,4,0,0,0,4,5.58289
27125,5831,76183.97,71508.05,44,0,0,0,44,6.15315
27126,16118,295175.19,225791.15,121,1,3,0,125,5.53609
27127,4800.38,44815.67,44815.64,32,0,1,0,33,7.3635
27129,2539.75,72876,53410.18,22,0,2,0,24,4.49353
27130,3090,128387,76888.76,33,0,1,1,35,4.55203
27132,6904.38,69757.8,69757.74,51,0,0,0,51,7.31102
27133,9431,141498.36,134653.18,52,0,2,0,54,4.0103
27134,4487,65381.73,54213.26,27,0,3,0,30,5.5337
27135,4448.13,56579.64,56579.49,36,0,1,0,37,6.53947
27136,4277.38,77832.2,77832.12,13,0,4,0,17,2.18419
27137,235,4148,4121.39,3,0,0,0,3,7.27909
27138,3699.88,127795.65,86602.87,26,0,1,0,27,3.11768
27139,801.25,27324,13506.81,5,0,0,0,5,3.70184
27140,989.75,13256.16,13256.17,9,0,0,0,9,6.78929
27141,757.5,14883,14787.53,9,0,0,0,9,6.08621
27142,2781.88,33071,32858.91,20,3,8,0,31,9.43427
27143,125,2700,2682.67,1,0,0,0,1,3.72762
27144,1457.5,25554,25390.2,10,0,1,0,11,4.33238
27146,3416.75,113936,85231.9,35,0,1,0,36,4.22377
27147,7382.25,91147.85,91148.03,49,0,1,0,50,5.48558
27148,3091.63,132783.19,76846.15,18,0,1,0,19,2.47247
27149,737.75,19248,19124.53,9,0,0,0,9,4.706
27151,7940.13,121862,121080.59,62,13,14,0,89,7.35048
27152,3351.25,17817,17702.72,7,12,2,0,21,11.8626
27153,2788.63,35076,34851.1,22,0,2,0,24,6.88644
27154,3617,41035.16,38951.33,28,0,0,0,28,7.18846
27155,541,4275.53,4275.51,4,0,0,0,4,9.35561
27156,5102.63,195530,100694.99,64,0,1,0,65,6.45514
27157,14739.5,222164.6,208544.28,118,0,4,1,123,5.89803
27158,2903.38,35011.22,35011.29,23,0,0,0,23,6.56931
27161,9065.25,120215.67,115498.9,70,0,2,0,72,6.23383
27162,2252,42767.77,28534.38,18,0,0,0,18,6.30818
27163,1954,29764.84,25886.98,17,0,0,0,17,6.56701
27164,5980.75,108882,93515.45,63,0,0,0,63,6.73685
27165,61650.88,391849.85,391849.55,319,100,23,0,442,11.2798
27167,4909.25,155733,121494.8,52,0,0,0,52,4.28002
27168,1270.25,13352.03,13352.06,9,1,1,0,11,8.23843
27169,9548.75,208643.56,154577.5,80,0,0,0,80,5.1754
27170,7542.13,130171,88581.28,59,15,12,0,86,9.7086
27171,3087,43104.58,43104.77,20,0,1,0,21,4.87185
27173,914.25,25028,18371.46,10,0,0,0,10,5.44323
27174,21257.75,261722.41,261386.53,94,0,7,0,101,3.86401
27175,4559.25,220292,60665.79,48,0,1,0,49,8.07704
27176,1144.88,14180,14089.06,11,0,1,0,12,8.51725
27177,2338,30717.18,24327.56,16,0,0,0,16,6.5769
27179,10714.75,123274.43,117713.57,56,0,4,0,60,5.09712
27180,14758,194545,161452.92,161,15,5,0,181,11.2107
27181,2296.38,53434,42931.85,23,0,1,0,24,5.59026
27182,639,8682.01,8681.97,5,0,0,0,5,5.75906
27183,9106.63,92778,92183.03,94,10,2,1,107,11.6073
27184,171,889.751,889.743,1,0,0,0,1,11.2392
27185,5093,64147.48,64147.46,49,0,1,0,50,7.79454
27187,2764.25,41664.92,35924.43,21,0,0,0,21,5.8456
27188,55482.75,287862.87,278709.85,94,10,8,1,113,4.0544
27189,6622,89394.68,83681.36,52,0,0,1,53,6.33355
27190,1151,21167.03,17986.33,4,0,3,0,7,3.89184
27191,12353.75,190748,179698.64,118,17,2,0,137,7.62388
27192,9842.38,84629.59,81054.66,26,0,15,0,41,5.05832
27193,3298,33206,32993.02,30,3,0,0,33,10.0021
27194,4663.38,53605,53261.28,24,0,0,1,25,4.69384
27196,8597,74842.87,64139.76,47,32,2,0,81,12.6287
27198,28766.75,521150.49,402966.14,207,38,20,0,265,6.57623
27199,2000.13,17732,17618.32,12,19,1,0,32,18.1629
27200,949,10895.26,10895.3,6,0,0,0,6,5.50696
27201,2345.25,22658.08,22658.11,14,0,0,0,14,6.1788
27202,2162.63,28734,28549.75,21,0,0,0,21,7.35558
27203,5385,58113.36,50820.23,17,0,15,0,32,6.29671
27204,2254.38,28369,28187.05,22,1,0,0,23,8.15977
27205,1201.25,19853,19725.7,11,0,0,0,11,5.57648
27206,2764.5,44274,43990.06,23,0,1,0,24,5.45578
27207,5444,156108.54,73785.86,26,0,0,0,26,3.52371
27208,310.25,4450,4421.47,3,0,1,0,4,9.04676
27209,8268.75,146934.54,146934.37,63,0,1,0,64,4.35569
27210,7273,112389.51,77550.72,31,0,3,0,34,4.38423
27212,811,11567.18,11567.12,7,0,0,0,7,6.05164
27213,24738.5,474820,353970.42,250,24,10,0,284,8.02327
27214,2337.38,25345,25182.44,22,5,0,0,27,10.7218
27215,2693.5,31131.26,31131.26,24,0,0,0,24,7.70929
27216,3469,40313.35,40313.17,25,0,1,0,26,6.44951
27217,9806.63,62464.88,62464.89,33,0,2,0,35,5.60315
27218,14753.5,373537,259624.04,138,6,13,1,158,6.08572
27219,7339.88,83525.52,83525.35,56,0,1,0,57,6.82428
27220,734.125,9197,9138.03,7,0,0,0,7,7.66029
27222,1678.88,40217,39959.02,15,0,0,0,15,3.75385
27224,5274.25,81575.95,72017.65,31,0,1,0,32,4.44336
27226,18678.5,185442,184252.82,167,23,22,0,212,11.5059
27227,6705.13,130831.92,94177.18,50,0,0,0,50,5.30914
27228,2485,30215.96,30216.2,18,0,0,0,18,5.95707
27229,225009.63,1220720.87,1138162.17,553,1792,212,9,2566,22.5451
27230,13691.88,94214,93609.69,93,118,10,1,222,23.7155
27231,2887.75,18899.53,18899.56,9,0,1,0,10,5.29113
27232,1759.63,21433,21295.53,19,0,0,0,19,8.92206
27233,11321,303525.51,163939.06,88,0,1,0,89,5.42885
27234,2140.5,19551.94,19551.95,20,1,0,0,21,10.7406
27235,446.25,9116,9057.55,5,0,0,0,5,5.52025
27237,1428.25,56810,24154,10,0,1,0,11,4.55411
27238,13061.5,128451.8,128451.79,77,1,4,1,83,6.46157
27239,2183.75,79621,53724.24,22,0,1,0,23,4.28112
27240,409,3174,3153.63,3,0,1,0,4,12.6838
27241,1416.13,26105.91,26105.81,13,0,0,0,13,4.97973
27242,7478.13,130594.87,113187.1,50,0,4,0,54,4.77086
27243,5023,120325.33,81847.06,35,3,0,0,38,4.64281
27245,1358.25,34107,30780.34,15,0,1,0,16,5.19812
27246,4053.5,49907,49586.91,42,0,3,0,45,9.07498
27247,1280.25,13620,13532.64,11,0,0,0,11,8.1285
27248,1126.13,40616,34083.95,13,0,0,0,13,3.81411
27249,11669.5,144679,143751.09,99,2,1,0,102,7.0956
27251,2251.25,37546,37305.12,29,0,0,0,29,7.77373
27252,1872.25,110464,27543.2,18,0,0,0,18,6.53519
27254,6733.88,85371.38,85371.28,34,0,7,1,42,4.91969
27256,4346.63,49159.94,48790.58,41,0,0,0,41,8.40326
27258,8496,180131.67,140301.75,42,0,2,0,44,3.1361
27259,808.375,13056,12972.31,9,0,0,0,9,6.93786
27260,8623.75,256619.2,160047.18,72,0,0,0,72,4.49867
27261,4260.13,68864.6,48485.52,16,0,2,0,18,3.71245
27263,4749.75,105618.02,91272.55,31,2,5,0,38,4.16335
27266,3245.38,57386,57018.01,36,0,0,0,36,6.3138
27267,1225.5,40623,31087.42,12,0,0,0,12,3.86008
27268,14892.38,61979,61581.48,23,0,1,0,24,3.89728
27269,2157.5,57786,51024.6,19,0,0,0,19,3.72369
27270,3859.25,50907,50580.51,39,0,1,0,40,7.90818
27271,4937.25,39828.14,39828.39,23,0,1,0,24,6.02585
27273,1541.75,20070,20070.01,12,0,1,0,13,6.47733
27275,20860.76,143629,142707.94,121,404,15,0,540,37.8395
27276,947.625,11679,11604.11,10,0,0,0,10,8.61763
27277,3403.75,38449.18,38408.26,30,0,0,0,30,7.81082
27278,10400.5,164198.07,120434.03,57,3,7,1,68,5.64624
27279,21684.63,130054.73,130054.81,112,22,14,0,148,11.3798
27280,4272.38,36430.12,36430.08,34,0,1,0,35,9.60745
27281,1587,35141,35141.06,11,0,0,0,11,3.13024
27282,3686,42664.62,38487.54,25,0,0,0,25,6.49561
27284,58436.5,319347.43,298657.79,191,640,39,0,870,29.1303
27285,1311,14199.21,14199.2,8,3,0,0,11,7.74692
27286,3272.13,130205,85987.92,23,2,1,0,26,3.02368
27287,4572,62296.22,62296.3,33,0,1,0,34,5.45779
27288,5400,113671,76143.62,58,2,0,0,60,7.87985
27289,620.625,35665,6566.61,3,0,0,0,3,4.56857
27290,6203.5,144053,131075.98,65,0,3,0,68,5.18783
27291,553.875,19398,10728.57,4,0,0,1,5,4.66045
27294,6511.13,97149,96525.98,60,0,0,0,60,6.21594
27295,2357.13,107433,51003.83,22,0,1,0,23,4.50946
27297,1588.75,57476,22411.41,15,0,1,0,16,7.13922
27298,2176.38,25636.16,23545.92,18,0,1,0,19,8.06934
27299,18428.5,111502.35,89535.17,128,35,14,0,177,19.7688
27300,2029.25,32191,27652.53,19,0,1,0,20,7.23261
27301,9350.88,120243.15,99136.2,63,0,3,0,66,6.65751
27302,8947,139923.94,139924,63,0,2,0,65,4.64538
27304,198.75,2140,2126.26,1,0,0,0,1,4.70309
27306,119030,611344.93,587760.07,143,13,103,0,259,4.40656
27307,3941.75,68131,60055.84,37,0,0,0,37,6.16093
27309,2894.63,48881,48567.52,31,0,0,0,31,6.38287
27310,1175.63,13568,13481.03,10,7,1,0,18,13.3521
27311,7542.5,107815.74,92551.43,56,3,1,0,60,6.48288
27312,1869,32252.24,25718.88,10,0,1,0,11,4.27701
27313,4542.13,52117.18,49561.71,36,0,0,0,36,7.26367
27315,834.625,34505,23327.93,5,0,0,0,5,2.14335
27316,8337.25,209284.35,146768.6,51,0,2,0,53,3.61113
27317,4999.5,102893.82,79088.33,37,0,0,0,37,4.67831
27318,2329,23123.9,23123.95,15,4,1,0,20,8.64904
27319,2400,41040.39,36349.47,19,0,1,0,20,5.50214
27320,1807,19395.26,19395.24,13,0,0,0,13,6.70267
27321,2756.63,28681.52,17347.18,8,0,1,0,9,5.18816
27322,5741.13,62610.76,60402.47,36,1,4,0,41,6.7878
27323,2296,115450,49099.13,25,0,2,0,27,5.49908
27324,1348.38,24485,24327.99,12,0,1,0,13,5.34364
27325,2332.75,47742,47117.83,25,0,0,0,25,5.30585
27326,2350,46430.52,46430.51,13,0,1,0,14,3.01526
27327,1975,32707.31,32707.37,13,0,1,0,14,4.28038
27329,2395.25,35586,35357.77,21,0,2,0,23,6.50493
27331,1993.25,24604,24446.19,19,0,0,0,19,7.77217
27332,13223.88,133774.31,132013.76,33,8,15,0,56,4.24198
27333,3055.63,53757,53412.27,30,0,0,0,30,5.61669
27334,823,25897,20832.51,10,0,0,0,10,4.80019
27335,7628.63,108222,107527.87,39,1,3,0,43,3.99896
27336,1804.63,39006.81,32166.42,17,0,0,0,17,5.28501
27337,1777.38,33049,32837.09,17,0,0,0,17,5.17707
27338,4346.25,84836,64494.79,40,0,1,0,41,6.3571
27339,4094.25,50460.36,45250.3,30,0,1,1,32,7.07178
27340,6126.75,115635.36,101948.98,44,0,0,0,44,4.31588
27341,413.75,16553,9635.75,4,0,0,0,4,4.15121
27342,999.125,30227.57,19869.38,11,0,0,0,11,5.53616
27343,5261.88,97302.73,74868.32,39,3,2,0,44,5.87699
27345,983.375,46534,31071.01,8,0,0,0,8,2.57475
27346,1064.63,30079,14117.9,12,0,0,0,12,8.49985
27347,6660.75,41956.49,41956.58,54,0,0,0,54,12.8704
27348,10874,77986.06,77986.08,74,55,4,0,133,17.0543
27349,8564,145912.9,138188.68,61,0,2,0,63,4.55898
27350,3035,58611,47696.2,33,0,2,1,36,7.54777
27351,5944.38,43714.59,43714.49,52,9,0,0,61,13.9542
27353,5370.38,59172.91,59172.89,40,0,0,0,40,6.75985
27354,2520.75,30443.34,30443.3,17,0,1,0,18,5.91263
27355,5071.13,42200,41929.36,39,15,3,0,57,13.5943
27358,2489,48574.6,48574.69,17,0,1,0,18,3.70563
27359,1246.75,65850,26417.81,15,0,0,0,15,5.67799
27360,1773.13,25419.12,25419.04,13,0,0,0,13,5.11428
27361,5162,152946.81,101426.91,37,0,0,0,37,3.64795
27363,1848,49709.27,30356.99,14,0,0,0,14,4.61179
27364,1094.38,14002,13912.2,4,0,4,0,8,5.75035
27365,7898,52126.83,52126.97,53,19,1,0,73,14.0043
27366,1715.5,19825,19697.81,16,0,0,0,16,8.12273
27367,9675.63,728745,164327.47,84,0,7,0,91,5.53772
27368,1361.38,16956,16847.29,13,0,0,0,13,7.71638
27369,714,14053,10661.22,6,0,0,0,6,5.62787
27370,1442,32217,21684.1,13,3,0,0,16,7.37868
27371,886.625,29155,18448.94,8,0,0,0,8,4.33629
27372,4523.38,70325,69873.99,46,0,1,0,47,6.72639
27373,502.5,37087,10929.47,6,0,0,0,6,5.48974
27374,2454.63,52834,36405.08,24,0,1,0,25,6.86717
27375,91006.25,457520.88,448579.91,359,469,33,3,864,19.2608
27376,1126.88,15530,15430.43,10,0,0,0,10,6.4807
27377,1804,17990,17874.62,15,10,5,0,30,16.7836
27378,4079.63,98955,63762.52,44,0,6,0,50,7.8416
27379,766.875,11741,11665.74,9,0,0,0,9,7.7149
27380,2759.25,215416.42,40731.61,18,0,1,1,20,4.91019
27381,1138.5,25265.2,23844.03,9,0,1,0,10,4.19392
27382,2594.75,28073.47,28073.53,16,0,0,0,16,5.69932
27383,1451.88,22943.48,19337.13,13,0,0,0,13,6.72282
27384,4007,98886.7,53985,32,0,1,0,33,6.11281
27385,29681.5,435573.65,266835.56,153,50,9,0,212,7.94497
27386,5210.25,28281.12,28281.36,61,20,0,0,81,28.6408
27388,2828.88,49992.26,47325.52,24,0,1,0,25,5.28256
27389,4781.25,71086.85,71086.76,39,0,0,0,39,5.48625
27390,8000,134764,133899.73,78,0,1,0,79,5.89994
27391,8986.25,124932,123772.23,75,4,4,2,85,6.86745
27392,1418.75,26746,26574.46,11,0,0,0,11,4.13931
27393,9425.25,307378.55,178326.45,73,2,1,0,76,4.26185
27394,2277.75,20863.04,20862.98,18,0,0,0,18,8.62772
27395,200.625,15085,2835.69,1,0,1,0,2,7.05295
27396,2863.13,53933,53587.16,30,0,3,0,33,6.15819
27397,6885.5,55247.29,55247.36,66,0,1,0,67,12.1273
27398,11252.13,142383,126157.74,95,0,14,0,109,8.63998
27399,601,8250.02,8249.99,2,0,1,0,3,3.63637
27400,1789,28498.01,25044.93,15,0,0,0,15,5.98924
27401,132,1928.83,1928.84,1,0,0,0,1,5.18447
27402,850.625,15033,14936.62,9,0,0,0,9,6.02546
27403,167.5,1849.84,1849.85,2,0,0,0,2,10.8117
27404,175.625,7900,7849.34,1,0,0,0,1,1.27399
27405,426.375,8881,8824.05,4,0,0,0,4,4.53307
27406,2000.88,17881.29,17881.28,15,0,1,0,16,8.9479
27407,1700.63,20917,20782.86,17,0,0,0,17,8.17982
27408,1591.63,27867,23740.47,15,0,0,0,15,6.31832
27410,22117.63,108542.35,108542.38,57,0,2,0,59,5.43566
27411,1373.25,18896,18774.81,14,0,0,0,14,7.4568
27412,11311.5,180477.81,120640.77,67,2,1,0,70,5.80235
27413,1447.75,44477,23028.45,15,1,3,0,19,8.25066
27414,5666.25,82036,81509.74,64,12,3,0,79,9.69209
27415,3707.88,209187,107534.97,33,11,2,0,46,4.27768
27416,3266.75,56148,55787.98,36,0,0,0,36,6.453
27417,5338.63,79478,78968.34,53,0,3,0,56,7.09145
27418,1476.13,48920,36798.45,16,0,0,0,16,4.34801
27419,2985.88,45361,45070.09,27,0,2,0,29,6.43442
27420,1224.5,7011,6966.06,6,0,1,0,7,10.0487
27421,1397.63,35735,26249.62,17,0,1,0,18,6.85724
27422,2817.63,39089,38251.08,27,2,0,0,29,7.58148
27423,2720.88,44625,44338.78,24,0,0,0,24,5.41287
27424,26339.25,35447,35219.66,7,0,2,0,9,2.55539
27425,20578.13,350738.57,276447.73,111,0,11,0,122,4.41313
27426,7059.13,71351,70893.34,65,0,0,0,65,9.1687
27427,2691.88,106118,49320.67,20,0,4,0,24,4.86611
27428,40884.38,336232.02,243737.18,235,53,16,2,306,12.5545
27429,676.25,11062.73,11062.72,6,0,0,0,6,5.42362
27430,3855.63,65574,65153.46,36,2,0,0,38,5.83238
27431,1398.88,27458,27281.97,13,9,1,0,23,8.43047
27432,8701,123693.59,123693.59,61,0,0,0,61,4.93154
27433,1263.13,38627,23689.14,16,0,0,0,16,6.75415
27434,89.375,2199,2184.9,1,0,0,0,1,4.57686
27435,3246.63,135540,71967.55,32,0,0,0,32,4.44645
27436,5205,87293.41,80020.56,34,0,0,1,35,4.37388
27437,2291.63,34626,34403.96,24,0,0,0,24,6.97594
27438,7979.88,65632,62033.66,25,101,11,0,137,22.0848
27439,7737,65066.69,65066.69,15,0,8,0,23,3.53483
27440,3084,43682,43401.87,23,0,2,0,25,5.76012
27441,285.875,16073.05,11673.23,2,0,0,0,2,1.71332
27442,416.875,16671,10880.74,4,0,0,0,4,3.67622
27444,1758.88,94664,52572.65,15,0,1,0,16,3.04341
27445,928.875,27993,6451.36,6,0,1,0,7,10.8504
27446,4992.38,65285.49,60230.88,35,0,2,0,37,6.14303
27447,3085.63,74413,73935.83,29,0,2,0,31,4.19282
27448,32638,165630.17,163456.8,92,44,16,2,154,9.42145
27451,964.5,15267.25,15267.26,8,0,0,0,8,5.23997
27453,21401.75,134852,133987.17,70,2,13,0,85,6.34389
27454,2584.5,56152,38902.87,28,0,0,0,28,7.19741
27455,1184.5,60801,29631.75,11,0,0,0,11,3.71223
27456,2577,41618.2,22305.63,15,0,1,0,16,7.17308
27457,5867.25,66298.83,65626.85,50,0,0,0,50,7.61883
27458,20458.5,135604.54,135604.62,162,5,4,0,171,12.6102
27459,413,8397,8343.16,4,0,0,0,4,4.79435
27460,1189,30898.33,28486.22,10,0,0,0,10,3.51047
27462,437.125,19143,11866.37,5,0,0,0,5,4.21359
27463,4140,177883,87196.16,39,0,6,0,45,5.16078
27464,6821,76288.04,76288.34,59,0,0,0,59,7.73382
27465,1687.38,39422.64,26563.06,14,0,0,0,14,5.27048
27466,2799.63,56402,49348.46,31,0,0,0,31,6.28186
27467,113722.25,574661.57,516048.37,270,675,93,1,1039,20.1338
27468,2449,48221.02,24888.82,15,0,3,0,18,7.23216
27469,24560.38,170336.64,155137.99,216,32,11,1,260,16.7593
27470,13049,72048,71585.87,45,11,13,1,70,9.77847
27471,213.125,2624,2607.18,2,0,0,0,2,7.67112
27472,2244.5,32017.36,32017.4,14,0,2,0,16,4.99728
27473,2180.38,43282,37400.49,21,0,1,0,22,5.88228
27474,2776.38,23471.2,23471.14,23,0,2,0,25,10.6514
27475,1163.75,30569,30372.98,12,0,0,0,12,3.95088
27476,1239,47439.62,21981.39,8,0,1,0,9,4.09437
27477,2599.25,28929,28743.48,21,0,0,0,21,7.306
27478,13411,117157.37,107449.28,82,0,8,0,90,8.37605
27480,4513,71417,70958.91,40,0,3,0,43,6.05985
27481,25539,391448.57,360055.49,26,0,317,0,343,9.52631
27482,335,3622.83,3622.83,3,0,0,0,3,8.28083
27483,1624.5,17862.37,17861.96,16,0,0,0,16,8.95758
27485,2330.13,22420.9,22420.91,25,2,0,0,27,12.0423
27486,6989.75,60322.63,60322.56,27,0,3,0,30,4.97326
27487,1416.5,20824,20690.4,13,0,0,0,13,6.28311
27488,832.125,33136,16421.03,8,0,0,1,9,5.48078
27489,4266,57837.08,57837.13,31,0,1,0,32,5.53278
27490,465.5,5122,5089.16,8,0,0,0,8,15.7197
27491,408,30261,21040.18,4,0,0,0,4,1.90112
27492,1625,38272,38026.5,20,0,0,0,20,5.25949
27493,21543,216303,202197.88,228,33,16,2,279,13.7984
27495,1499.13,18935,18813.57,15,0,0,0,15,7.97297
27496,1819.75,32884,32673.14,19,0,0,0,19,5.81517
27497,12781.38,223105.42,165139.59,100,0,2,0,102,6.17659
27498,2207.38,42516,42243.39,25,0,0,0,25,5.91809
27500,13101.25,183185.31,106204.37,70,14,4,0,88,8.28591
27501,2792.25,42547.38,42547.39,26,0,0,0,26,6.11083
27502,6662.38,111423,95241.31,66,17,8,1,92,9.65967
27504,20292.63,207307.86,192652.52,159,0,6,0,165,8.56464
27505,953.125,45896,34920.63,9,0,0,0,9,2.57727
27507,32753.38,349351,303557.55,240,53,25,1,319,10.5087
27508,1932.75,74337,43645.32,17,0,2,0,19,4.35327
27511,3972.75,45807.63,45807.63,34,0,0,0,34,7.42234
27512,2666.13,108438,68320.89,25,0,0,0,25,3.6592
27514,1767.13,104469,38695.22,18,0,1,0,19,4.91017
27516,3362.13,152108,72077.69,30,0,0,0,30,4.16218
27517,25683.63,410572,290232.21,128,1,20,0,149,5.13382
27518,10284.5,234603.88,139595.79,74,0,0,0,74,5.30102
27520,648.125,35817,16484.54,7,0,0,0,7,4.2464
27521,296,15094.12,8547.91,3,0,0,0,3,3.50963
27522,4423.5,189158,96056.86,43,0,0,0,43,4.47652
27523,2145.38,111700,40905.97,20,0,2,0,22,5.37819
27524,11184,139213.41,133320.13,72,0,1,0,73,5.47554
27525,2895,38709.54,38709.55,28,0,0,0,28,7.23336
27527,510,40691,13812.86,7,0,0,0,7,5.06774
27528,27270.5,154105.6,154105.35,162,31,10,0,203,13.1728
27529,4016.63,128460.48,68305.57,22,0,2,0,24,3.51362
27530,427,17263,9528.52,4,0,0,0,4,4.19792
27531,2825,59607.71,53905.2,17,0,0,0,17,3.15368
27533,2581.88,39571,39317.28,20,0,5,0,25,6.35853
27534,7223.38,65586.29,59531.83,46,0,3,1,50,8.39887
27535,2072,26247.93,26247.94,16,0,1,0,17,6.4767
27536,4613.75,59815.7,59815.68,32,0,1,0,33,5.51695
27537,5510.38,77908.99,57954.92,52,4,0,0,56,9.66268
27538,3522,85255,59208.79,43,7,1,0,51,8.61359
27539,3158,37158,36919.7,28,0,0,0,28,7.58403
27540,2268.75,35930.98,29316.24,13,4,1,0,18,6.13994
27541,1368.88,44134,36137.68,13,0,0,0,13,3.59735
27542,5911.38,131065,123815.86,65,3,0,0,68,5.49203
27543,3587.25,56253,55892.2,34,1,1,0,36,6.44097
27544,1597,13275.31,13275.27,14,0,0,0,14,10.5459
27545,84,3040.09,3040.11,1,0,0,0,1,3.28936
27546,260,5544.59,5544.6,2,0,0,0,2,3.60712
27547,6805.13,220316,113577.87,77,0,1,1,79,6.95558
27548,4134,59835,57907.25,42,3,1,0,46,7.94374
27549,12552,103523.55,87899.92,72,57,3,0,132,15.0171
27550,1924,60001,34484.37,20,0,0,0,20,5.79973
27551,125,3411,3389.15,1,0,0,0,1,2.95059
27552,1688.5,98045,41311.38,16,0,1,0,17,4.11509
27553,2477,63087,39917.39,30,0,0,0,30,7.51552
27554,10271,134651.83,125197.49,84,0,0,1,85,6.78927
27555,968.75,34235,15713.62,11,0,0,0,11,7.0003
27556,785,50423,22584.23,8,0,0,0,8,3.54229
27557,771.375,55032,31671.51,7,0,0,0,7,2.21019
27558,1588,29420.44,29420.6,11,0,1,0,12,4.07877
27560,3060,205398.38,38871.58,16,0,1,0,17,4.37338
27561,18771,285437.04,128059.75,46,6,7,0,59,4.60722
27562,120749,469076.01,451084.15,65,27,85,1,178,3.94605
27563,6651.38,115899.58,91862.19,49,0,0,0,49,5.33408
27564,2774.75,148668.63,65342.2,19,0,3,0,22,3.36689
27565,8737.63,719280.1,142264.52,74,0,0,1,75,5.27187
27567,722.125,9291,9231.42,8,0,0,0,8,8.66605
27568,4297,52220.76,52220.7,28,0,0,0,28,5.36186
27569,5208,66965.25,52786.25,12,0,1,0,13,2.46276
27570,815,6492.49,6492.46,5,0,0,0,5,7.70124
27571,2853.5,47444,47139.65,29,0,0,0,29,6.15193
27572,4031,48202.11,48202.13,31,0,0,0,31,6.43125
27576,4769.5,148221,147270.41,43,0,1,0,44,2.9877
27577,2830.75,73174.82,57667.38,21,0,0,0,21,3.64157
27578,4878.88,92370.23,83538.72,42,0,3,0,45,5.38672
27579,437.25,4841.73,4841.7,4,0,0,0,4,8.26155
27580,22210.25,213080.8,205866.31,168,5,2,0,175,8.50066
27581,3366.5,83283.59,58755.5,25,0,0,0,25,4.25492
27582,8660.5,79888.19,75054.47,70,4,1,0,75,9.99274
27584,4339,64230.94,61120.42,34,0,0,0,34,5.56279
27586,1020,22555.07,22554.95,8,0,0,0,8,3.54689
27587,3985.76,134949,75682.34,39,2,4,0,45,5.94591
27589,1781.75,31905,31700.38,13,0,1,0,14,4.41635
27590,1206.38,28997,24368.72,13,0,0,0,13,5.33471
27591,3535.75,151277,72550.71,39,0,0,0,39,5.37555
27592,1616,34811,26513.83,17,0,0,0,17,6.41175
27593,13357.13,116724.48,116724.35,117,5,14,0,136,11.6514
27594,2883.75,79899,60384.2,31,0,1,0,32,5.2994
27595,4478,66402.91,64062.78,38,0,0,0,38,5.93168
27597,5763.13,105750.86,90021.93,43,0,0,0,43,4.77661
27598,1804.75,18273.86,18273.84,15,14,0,0,29,15.8697
27599,3905.25,68711,67152.52,35,3,4,0,42,6.25442
27600,1812.5,68955,27024.62,12,0,1,0,13,4.81043
27601,4553.5,121872.87,110976.34,41,0,0,0,41,3.69448
27602,49062,330174.4,326185.47,328,169,20,0,517,15.8499
27603,2552.13,86305,53630.83,26,0,0,0,26,4.84796
27604,2672.63,72950.8,37804.43,7,0,2,0,9,2.38067
27605,1418,92267,34843.03,14,0,0,0,14,4.01802
27606,8424.25,166388.04,125951.23,52,4,2,0,58,4.60496
27607,3366,78257.17,69472.45,22,0,1,0,23,3.31066
27608,3338.25,62709,50955.61,38,0,0,0,38,7.45747
27609,1567,54816,44101.32,15,0,1,0,16,3.62801
27610,215,30536.7,7125.23,2,0,0,0,2,2.80693
27611,1164,28534.89,14218.28,8,0,0,0,8,5.62656
27612,4535.75,61022.98,56424.72,32,0,3,0,35,6.20295
27613,4997.38,167363,117738,50,0,3,0,53,4.50152
27614,1173.88,22302,22159.02,13,0,0,0,13,5.86669
27615,1627,14696.7,14696.72,13,0,0,0,13,8.84551
27616,9447.25,80393.89,76389.84,65,0,2,0,67,8.7708
27617,3337,35669,35440.2,37,0,0,0,37,10.4401
27618,6744,111819.25,109560.48,56,0,1,0,57,5.20261
27620,4094.38,89895.28,87266.54,30,0,1,0,31,3.55234
27621,1255.75,38269,21786.47,5,0,10,0,15,6.88501
27622,9978.13,128416,118548.86,79,32,8,1,120,10.1224
27623,5107,47300.25,47300.31,42,0,0,0,42,8.87943
27624,6149.88,65529.05,65529.01,55,0,0,0,55,8.39323
27625,3206.88,41596,41329.24,37,0,0,0,37,8.9525
27627,2766.25,62404,51082.33,19,0,2,0,21,4.11101
27629,10547.13,126680,107545.84,129,4,8,0,141,13.1107
27630,1787.13,44844,30616.32,17,0,1,0,18,5.87922
27631,3861,57468.76,57468.65,34,0,0,0,34,5.91627
27632,2804.13,38868,38618.72,31,0,0,0,31,8.02719
27633,1642.75,17519,17406.63,16,8,0,0,24,13.7878
27635,1606.75,28205,28024.08,16,0,0,0,16,5.70938
27638,42322.88,461009.81,390273.76,259,6,11,1,277,7.09758
27640,779.25,15764,15662.94,8,0,0,0,8,5.1076
27641,3068.25,61707.66,44456.21,26,0,0,0,26,5.84845
27642,1360.38,35042,23091.19,13,0,3,0,16,6.92905
27643,19214.5,69217.75,64584.32,6,0,18,0,24,3.71607
27644,1616.38,33227,21876.81,16,0,1,0,17,7.77078
27645,1919.88,37298.72,31916.41,12,0,2,0,14,4.38646
27646,7186.88,145324.99,92966.61,59,0,1,0,60,6.45393
27649,1944.63,27953,27773.79,20,0,0,0,20,7.20103
27650,9025.25,130241.84,111226.3,48,0,2,1,51,4.58525
27651,106,1743.94,1743.95,0,0,1,0,1,5.73412
27652,2799,37732.09,37732.14,19,0,0,0,19,5.03549
27654,15686.5,200234.79,196475.59,100,0,3,0,103,5.24238
27655,7916.63,204296.35,146443.94,50,0,3,0,53,3.61913
27656,12123,287231.01,130844.14,87,4,1,1,93,7.10769
27657,2697,56018.61,48926.62,20,0,0,0,20,4.08775
27658,3160.13,61606.13,45037.6,22,0,0,0,22,4.88481
27659,1553,18883.06,18883.06,9,0,0,0,9,4.76618
27660,5179.13,133078.68,95681.95,21,4,5,0,30,3.13539
27661,4509,68417.83,44886.01,16,6,9,0,31,6.90638
27662,4401.63,155123.1,119585.86,34,0,0,0,34,2.84315
27663,1402,28564.44,24242.99,12,0,0,0,12,4.94988
27664,3737.5,78422,75652.63,34,0,1,0,35,4.62641
27665,7623,217145.74,138364.45,52,0,4,0,56,4.04728
27666,3419,40151.94,40152.06,26,0,0,0,26,6.47538
27667,2672.75,43033.81,43033.75,20,0,0,0,20,4.64752
27668,1114,20967.67,20967.7,8,0,0,0,8,3.81539
27669,5009.63,180606.22,73802.94,35,0,0,0,35,4.74236
27670,4360.25,68937,68494.86,43,0,1,0,44,6.42384
27671,2616,71001.1,53153.87,17,0,1,0,18,3.3864
27672,340.125,4494,4465.18,3,4,0,0,7,15.6768
27673,934.875,8569,8514.01,7,0,0,0,7,8.22174
27674,2795.25,32022.55,32022.5,18,0,0,0,18,5.62105
27676,7288,138289,99656.82,64,0,5,0,69,6.92376
27677,3991.63,48941.62,48941.61,32,0,0,0,32,6.5384
27678,5250.88,55776.85,55776.88,40,0,0,0,40,7.17143
27679,94368.13,665246.36,636029.08,341,114,52,1,508,7.98706
27680,1425.38,43366,22442.11,13,0,1,0,14,6.23827
27681,131305,666295.45,586633.53,452,784,82,1,1319,22.4842
27682,2068.25,24310,24154.07,23,0,0,0,23,9.5222
27683,832,24011,23856.95,7,14,0,0,21,8.80247
27684,49509,217661.82,217661.77,26,3,91,0,120,5.51314
27685,2344.63,55535,41684.92,23,0,2,0,25,5.99737
27686,560,21237.86,11517.54,4,0,0,0,4,3.47296
27689,2265.13,25722.12,25722.08,18,0,0,0,18,6.99788
27690,2167.5,33699,33482.81,23,0,0,0,23,6.8692
27691,4785.13,60490,60102.11,47,0,0,0,47,7.82003
27692,1241.38,25169.82,15297.4,7,0,0,0,7,4.57594
27693,10793,225982,169022.65,55,0,7,0,62,3.66815
27694,1610.38,24079.98,24079.91,14,0,0,1,15,6.22926
27695,1106,15126.73,15126.69,7,0,0,0,7,4.62758
27696,3874.13,79865.27,41498,30,0,0,1,31,7.47024
27697,29475,141332.93,141333.04,17,0,7,0,24,1.69812
27698,6460.5,57158.34,57158.34,40,0,3,0,43,7.52296
27699,1363.63,22507.28,19617.26,11,0,0,1,12,6.11706
27700,5340.25,71206.83,66065.1,37,0,1,0,38,5.7519
27701,79901.13,466332.88,445808.81,247,315,56,1,619,13.8849
50002,77866,400525.33,388784.72,125,132,68,3,328,8.43655
50003,43338,270370.25,247569.14,294,61,23,3,381,15.3896
50004,5930.63,118072.92,90079.65,30,0,3,0,33,3.66342
50006,2201.38,62568.81,55736.96,11,0,1,0,12,2.15297
50007,1185,34340.47,22773.32,8,0,0,0,8,3.51288
50008,2545,26025.47,26025.47,16,12,0,0,28,10.7587
50013,3193,37786.98,33306.01,23,0,0,0,23,6.90566
50014,2346,33816.37,29147.32,17,0,1,0,18,6.17552
50015,9731,93827.68,91028.52,69,5,1,1,76,8.34903
50016,834,24297.36,16128.79,8,0,0,0,8,4.96007
50019,3662.25,42031.68,35420.72,23,5,1,0,29,8.1873
50021,870.25,22620.05,16148.58,4,0,0,0,4,2.477
50022,916,16157.56,16157.55,7,0,0,0,7,4.33234
50023,6882,101070.1,101070.1,37,0,1,0,38,3.75977
50024,2584,72787.2,40114.33,15,0,1,0,16,3.9886
50025,26483,140192.56,136306.48,91,90,36,1,218,15.9934
50026,535,5697.96,5697.96,3,0,0,0,3,5.26504
50027,16275,296869.45,183857.83,108,0,2,0,110,5.98288
50028,211,4276.08,4276.08,1,0,0,0,1,2.33859
50029,9694,134631.27,71232.26,36,14,5,0,55,7.72122
50030,4749,23545.99,23545.99,32,37,4,0,73,31.0032
50031,35051,294433.44,273461.08,239,58,21,2,320,11.7018
50032,10294.5,115762.11,113872.05,63,0,3,0,66,5.79598
50033,2194,24505.23,24505.23,15,0,0,0,15,6.12114
50034,8955.38,95853.34,95853.34,62,0,0,0,62,6.46821
50036,2267.63,32566.77,28025.83,20,0,0,0,20,7.13627
50038,3846,48697.67,39690.19,29,0,1,0,30,7.55854
50039,1316,33827.15,29321.75,7,0,1,0,8,2.72835
50040,852,10519.02,10519.02,8,0,0,0,8,7.60527
50041,131948.13,1679383.21,1234817.41,809,18,52,1,880,7.12656
50042,7529.75,47984.18,47984.21,16,0,6,0,22,4.58484
50044,3687.75,75851.58,58312.11,25,0,0,2,27,4.63026
50045,11062,221575.07,106311.31,56,0,5,1,62,5.83193
50046,7682.63,118243.92,105073.25,40,0,1,0,41,3.90204
50048,7283.75,119789.93,95471.03,52,0,1,0,53,5.55142
50049,7431,143862.67,128545.7,57,0,2,0,59,4.58981
50050,277,1746.57,1746.58,1,0,0,0,1,5.72549
50052,923.375,21816.21,21816.21,6,0,0,0,6,2.75025
50054,2503,37418.76,37418.76,17,0,1,0,18,4.81042
50055,1106,35232.85,20904,8,0,0,0,8,3.82702
50058,33949.63,323652.71,281997.17,231,0,12,0,243,8.61711
50059,4274,71383.61,61793.13,28,0,0,0,28,4.53125
50060,4170.88,111598.28,91351.81,25,0,1,0,26,2.84614
50062,644,14784.88,14784.88,3,0,0,0,3,2.0291
50064,2452,45224.12,41852.29,18,0,1,0,19,4.53978
50066,40836.25,390566.91,350268.62,267,92,6,0,365,10.4206
50069,5562.5,84162.85,81791.43,32,0,2,0,34,4.15691
50070,379,3529.78,3529.79,3,0,0,0,3,8.4991
50072,3534,66142.64,63648.9,27,0,0,0,27,4.24202
50074,28974,293052.17,260117.98,153,20,13,1,187,7.18905
50076,47736,301574.36,260028.66,304,121,24,3,452,17.3827
50077,8269.5,77257.51,74130.02,55,0,2,0,57,7.68919
50078,10804,123516.97,116909.96,77,0,0,0,77,6.58627
50079,3242.38,45507.34,45507.32,22,0,1,0,23,5.05413
50081,14281,193537.68,110878.45,76,0,2,0,78,7.03473
50082,55907.5,651625.14,594586.28,290,22,25,0,337,5.66781
50083,8839.88,153242.72,130749.37,38,0,7,0,45,3.4417
50084,5490,76771.59,55458.17,44,0,0,0,44,7.93391
50085,17879,189814.32,178531.97,142,0,3,1,146,8.17781
50086,4204,100889.05,65488.89,30,0,0,0,30,4.58093
50087,24738,221756.93,208927.32,91,0,27,0,118,5.6479
50088,629,18246.49,18246.5,3,0,0,0,3,1.64415
50090,3922,67582.97,33042.88,21,0,1,0,22,6.65802
50092,6022,83026.6,83026.6,41,0,0,0,41,4.93818
50093,3390.25,51002.42,46175.56,25,0,1,0,26,5.63068
50094,3813.13,56250.74,56250.74,31,0,0,0,31,5.51104
50095,16684,265074.18,142655.38,83,5,16,3,107,7.50059
50096,2368,40844.31,36185.75,19,0,0,0,19,5.25069
50097,1530,12491.9,12491.91,6,0,0,0,6,4.80311
50098,5234,106115.57,102035.89,40,0,1,0,41,4.01819
50099,70886.5,768537.44,539073.55,273,59,38,3,373,6.91928
50101,892,14173.03,14173.03,7,0,0,0,7,4.93896
50102,11491,84288.48,84288.5,72,17,5,0,94,11.1522
50103,4350.63,42466.45,32302.61,14,0,1,0,15,4.64359
50105,478.875,12850.19,7332.49,3,0,0,0,3,4.09138
50106,17955.63,121461.01,121460.96,13,0,2,0,15,1.23496
50107,7125,96104.71,63078.02,10,0,5,0,15,2.37801
50108,6270,69615.49,48998.09,23,0,2,0,25,5.10224
50109,17510.25,153530.47,146520.7,103,2,11,0,116,7.91697
50110,11308,170229.69,143169.4,61,3,4,1,69,4.81947
50111,6878.63,103373.2,100315.93,52,0,0,0,52,5.18362
50112,2882,72960.64,57557.52,17,0,3,0,20,3.47478
50115,6353.25,115191.94,106861.37,36,0,0,0,36,3.36885
50117,5587,54124.12,49736.27,32,0,1,0,33,6.635
50118,6645,93902.93,93902.9,31,0,11,0,42,4.47271
50120,4238.38,82495.44,77534.44,25,0,1,0,26,3.35335
50121,2276,59700.76,45107.74,14,0,2,0,16,3.54706
50124,1408.38,49499.71,28078.69,12,0,1,0,13,4.62985
50126,2544,30370.03,30370.01,16,0,0,0,16,5.26835
50129,466894.5,2507799.27,2231661.53,1476,1689,439,14,3618,16.2121
50130,3384,73743.14,47155.94,21,0,0,0,21,4.45331
50135,5729,63806.32,58543.02,20,0,3,0,23,3.92874
50137,14927,186982.63,143949.5,53,0,13,0,66,4.58494
50138,4992.25,65123.26,62530.32,37,0,1,0,38,6.07705
50139,47906.25,735405.9,563869.42,270,6,14,1,291,5.16077
50140,4019.5,72002.32,51479.83,34,0,0,0,34,6.60453
50142,8140.25,138866.29,85532.9,62,0,4,0,66,7.71633
50143,6387.13,58424.67,58424.67,44,4,0,0,48,8.21571
50144,2489,39046.76,34120.36,15,0,1,0,16,4.68928
50145,4825.63,80052.8,72841.85,36,0,0,1,37,5.0795
50146,1254,34288.13,19256.18,8,0,1,0,9,4.67382
50147,88240,412048.48,390907.59,185,146,67,3,401,10.2582
50148,5012,68707.06,66027.97,34,0,2,0,36,5.45224
50149,14117.5,133082.29,122466.01,113,0,4,0,117,9.55367
50150,2917,60932.48,57824.49,26,0,0,0,26,4.49637
50151,37118,300768.51,296221.1,174,19,13,3,209,7.05554
50152,490,7849.7,7849.7,3,0,0,0,3,3.8218
50155,3836,63479.97,58508.14,27,0,0,0,27,4.61474
50156,174.25,4507.38,4507.38,2,0,0,0,2,4.43717
50158,2219,107144.87,33959.98,5,6,2,0,13,3.82804
50159,5055,66541.04,66541.06,25,0,3,0,28,4.20793
50160,14137.13,171439.57,162723.91,102,3,6,0,111,6.82137
50161,7778.25,230139.94,94411.43,22,0,5,0,27,2.85982
50162,9092,91573.93,91573.92,57,1,1,0,59,6.44288
50164,15822,173733.78,155304.49,91,0,4,0,95,6.11702
50165,21975,93327.88,93327.87,136,32,5,0,173,18.5368
50166,2944,67099.37,55400.14,18,0,0,0,18,3.24909
50167,10843,148904.28,126998.12,63,0,5,0,68,5.35441
50168,29813.5,257694.78,242845.51,177,12,13,0,202,8.31805
50169,9224.13,91434.41,71851.25,7,0,0,0,7,0.974235
50172,3065.13,44431.71,44431.71,20,0,1,0,21,4.72635
50174,2361,25766.47,25766.46,19,0,0,0,19,7.37393
50175,1206.13,12892.96,12892.94,9,0,0,0,9,6.98056
50176,3270,60079.33,56409.79,21,0,1,1,23,4.07731
50177,3653.88,61784.87,58767.27,31,0,1,0,32,5.44521
50178,6652.38,81143.95,73715.98,46,0,1,0,47,6.37582
50181,4581,64673.01,53995.73,25,0,2,0,27,5.0004
50182,3867,72097.28,52695.8,26,0,1,0,27,5.12375
50183,2701.63,58279.33,40386.86,22,0,0,0,22,5.44732
50184,13072,105875.06,101301.54,116,2,4,0,122,12.0433
50185,16136,238394.01,212631.08,100,6,4,0,110,5.17328
50186,1480,48130.17,19804.5,11,0,0,0,11,5.55429
50188,11775,166347.87,139861.81,97,0,1,0,98,7.00692
50190,1659,23041.68,23041.68,13,0,0,0,13,5.64195
50192,2404,37096.81,37096.8,17,0,0,0,17,4.58261
50193,1098.75,18802.61,18802.62,8,0,0,0,8,4.25473
50194,2360,45260.54,40745.92,15,0,0,0,15,3.68135
50195,1253,32486.35,32486.36,10,0,0,0,10,3.07821
50196,4089,51896.39,51896.4,26,0,0,0,26,5.00998
50197,15883.75,164744.45,126577.34,99,1,10,0,110,8.69034
50198,2671.13,87465.36,40231.74,20,0,0,0,20,4.9712
50199,5647,89702.58,67726.16,33,0,4,0,37,5.46318
50200,7831.25,584478.17,85979.58,41,3,2,0,46,5.35011
50205,4946.75,75205.97,75205.99,38,0,0,0,38,5.05279
50206,1836,28537.83,28537.81,10,0,1,0,11,3.85453
50207,1021,20154.14,20154.12,6,0,0,0,6,2.97706
50208,1066,26370.92,21837.08,7,0,0,0,7,3.20556
50209,12654.5,194182.53,172057.49,79,0,4,0,83,4.82397
50210,1481,53988.86,26084.68,9,0,1,0,10,3.83367
50214,2945,74253.71,56714.88,16,0,1,0,17,2.99745
50215,39826.63,374865.79,362174.87,275,13,11,2,301,8.3109
50216,7951.75,145518.78,127889.97,43,0,3,0,46,3.59684
50217,5467,93447.58,82610.64,33,0,1,0,34,4.11569
50218,116996,470587.78,470587.79,434,672,96,0,1202,25.5425
50219,8081.5,134453.89,84879.2,43,0,3,0,46,5.41947
50221,319,9737.34,9737.34,3,0,0,0,3,3.08093
50222,14990,120444.27,115901.52,66,0,4,0,70,6.03961
50223,408,13063.83,8121.65,4,0,0,0,4,4.92511
50225,219,9702.5,9702.5,2,0,0,0,2,2.06132
50227,1792,31868.96,26711.51,22,0,0,0,22,8.23615
50228,9413,117917.94,117917.95,55,0,5,0,60,5.08828
50230,4176,73123.73,58950.76,27,0,2,0,29,4.91936
50231,8480,54369.46,54369.46,64,14,5,0,83,15.2659
50232,4376.75,75268.25,66420.84,29,0,1,0,30,4.51665
50233,1626.5,24278.94,24278.93,12,0,0,0,12,4.94256
50235,4548.88,88968.5,77993.99,32,0,3,0,35,4.48753
50236,50797.63,559732.23,495132.06,247,7,27,1,282,5.69545
50237,9882,59285.98,59285.97,56,20,10,0,86,14.506
50238,4495,47389.15,47389.16,14,0,1,0,15,3.16528
50239,24170,301605.43,246804.2,134,0,7,0,141,5.71303
50240,7857,79726.53,79726.55,62,0,1,0,63,7.90201
50241,1100.5,23325.49,22004.04,7,0,1,0,8,3.6357
50243,4257,78113.12,69551.93,32,0,0,0,32,4.60088
50244,5704,46425.09,46425.06,30,0,3,0,33,7.10823
50246,901,23715.21,13609.83,7,0,0,0,7,5.14334
50247,1823,48369.54,34715.45,14,0,0,0,14,4.03279
50248,1937.5,77271.36,36561.75,9,0,2,0,11,3.00861
50251,2064.5,40776.02,33737.44,14,0,0,0,14,4.14969
50252,13182,169208.55,151374.33,84,0,5,0,89,5.87946
50253,1816.5,34555.46,31143.16,17,0,1,0,18,5.77976
50256,40405.13,882420.34,616026.42,205,1,15,0,221,3.58751
50258,917,16274.24,16274.24,8,0,0,0,8,4.91574
50259,7963.38,177409.86,88680.75,60,0,0,0,60,6.76584
50260,15975.63,220161.45,172265.37,55,3,11,1,70,4.0635
50261,683.125,9417.48,9417.48,4,0,0,0,4,4.24742
50262,4301.88,65197.33,65197.33,29,0,0,0,29,4.44804
50263,1236.25,39334.64,28234.14,9,0,1,0,10,3.54181
50265,849,14201.64,14201.64,5,0,0,0,5,3.52072
50266,2621,40225.78,29907.05,19,0,0,0,19,6.35302
50267,26866,309790.37,247711.13,164,11,27,1,203,8.19503
50268,2060.63,26194.21,26194.22,14,0,1,0,15,5.72645
50269,3251,155617.16,49993.95,14,0,1,0,15,3.00036
50270,4570.63,101001.06,52086.74,31,0,1,0,32,6.1436
50271,540,10729.39,10729.39,4,0,0,0,4,3.72808
50272,29660,193143.67,173162.62,112,0,8,2,122,7.0454
50273,7588,108517.64,97508.88,49,0,0,1,50,5.12774
50274,8734,102350.94,89457.93,67,0,1,0,68,7.60134
50275,370,7648.74,7648.75,3,0,0,0,3,3.92221
50276,3708,75822.55,59360.79,23,0,1,0,24,4.04307
50277,11503,70143.78,70143.79,40,0,9,0,49,6.98565
50278,4231.88,41549.79,41549.79,33,1,0,0,34,8.18295
50279,8149.13,157821.8,116886.46,37,0,1,1,39,3.33657
50281,7014.25,94202.54,94202.5,57,0,1,0,58,6.15695
50282,3056,51223.88,46475.71,22,0,0,0,22,4.73366
50283,1225,12533.24,12533.24,10,0,0,0,10,7.97878
50285,3960.63,94350.44,67011.61,21,0,1,0,22,3.28301
50288,14962.63,99761.83,91514.68,97,13,3,0,113,12.3477
50289,4243,73024.11,67107.6,20,0,2,2,24,3.57635
50290,2901,83581.34,46114.15,15,0,1,0,16,3.46965
50291,100,7986.7,7986.7,1,0,0,0,1,1.25208
50292,45001.25,362117.8,356143.8,212,3,19,0,234,6.57038
50294,19123,132897.46,120681.42,76,2,19,0,97,8.03769
50295,719,16451.12,10469.91,6,0,0,0,6,5.73071
50296,79,1112.3,1112.3,1,0,0,0,1,8.9904
50297,6073,91307.3,72001.96,43,0,0,0,43,5.97206
50298,4759,66314.9,66314.92,22,0,3,0,25,3.76989
50299,2395.5,34181.18,27263.5,17,0,0,0,17,6.23544
50300,630,9807.15,9807.15,4,0,0,0,4,4.07866
50301,1731,38192.73,20303.53,12,0,0,0,12,5.9103
50302,1590,17516.98,17516.98,12,0,0,0,12,6.8505
50304,2230.13,38404.44,32493.8,18,0,0,0,18,5.53952
50305,9283,122294.66,99602.89,54,0,1,1,56,5.62233
50308,4344.38,78690.6,70167.94,29,0,0,0,29,4.13294
50310,1715,29683.82,29683.83,14,0,0,0,14,4.71637
50311,2216,36985.49,36985.5,14,0,2,0,16,4.32602
50312,2875,21830.13,21830.13,5,0,0,0,5,2.29041
50313,1681,33865.09,33865.1,11,0,0,0,11,3.24818
50315,2760.5,47886.77,47886.8,10,0,0,0,10,2.08826
50317,4573,68447.39,63707.9,29,0,0,0,29,4.55203
50320,1528,22620.72,18775.66,12,0,0,0,12,6.39125
50321,8616,132149.91,107117.33,48,0,1,0,49,4.57442
50324,1140.75,28178.32,28178.33,7,0,0,0,7,2.48418
50326,790,7467.97,5607.55,9,0,0,0,9,16.0498
50327,2527.38,226877.4,33671.19,16,0,0,0,16,4.75184
50328,12236,224468.76,210517.03,81,0,0,0,81,3.84767
50332,8755,133723.21,108776.64,68,0,5,0,73,6.711
50334,1297,29326.43,29326.41,8,0,1,0,9,3.06891
50335,4363,69216.75,69216.77,25,0,0,0,25,3.61184
50336,1296,28910.21,24518.13,7,0,0,0,7,2.85503
50338,2228,52651.38,32050.69,10,0,1,0,11,3.43206
50340,652,19794.38,9937.62,4,0,0,0,4,4.02511
50341,20963.13,169650.01,169649.94,109,15,18,0,142,8.37018
50342,8315.25,135984.85,107466.54,65,0,2,0,67,6.2345
50345,7792,106032.24,88022.2,51,0,0,0,51,5.79399
50347,2353.63,57327.38,36333.69,13,0,0,0,13,3.57795
50348,6921,120626.68,102663.23,44,0,3,0,47,4.57808
50349,25631,216890.6,211808.42,187,0,7,0,194,9.15922
50350,4123.88,57968.61,57968.61,30,0,0,0,30,5.17521
50352,2510,45301.45,45301.46,15,0,0,0,15,3.31115
50353,312,830.54,830.54,0,0,1,0,1,12.0404
50354,6127,76175.23,76175.19,44,0,2,0,46,6.03871
50356,7847,137976.35,108854.73,42,0,5,0,47,4.31768
50357,144,5879.14,5879.14,1,0,0,0,1,1.70093
50358,3604,53697.72,51337.57,26,0,1,0,27,5.25931
50359,20291,245536.63,240531.36,99,4,11,0,114,4.73951
50360,1768.63,34660.82,34660.84,11,0,1,0,12,3.46212
50361,3573,61153.49,42954.48,26,0,1,0,27,6.28572
50362,2273,28257.27,28257.27,13,0,0,0,13,4.60059
50363,20945.75,276785.04,222423.42,109,5,11,0,125,5.61991
50364,6256.38,119227.52,107982.45,49,0,0,0,49,4.53777
50365,6479.38,102281.84,83615.49,49,0,1,0,50,5.97975
50368,796,9910.29,9910.29,3,0,1,0,4,4.03621
50369,4506,78962.04,72701.42,30,0,1,1,32,4.40156
50370,5234.25,98154.19,90705.4,41,0,0,0,41,4.52013
50371,2862,28463.94,27957.21,16,9,5,0,30,10.7307
50372,1871,24729.65,24729.65,10,0,0,0,10,4.04373
50373,382,4749.5,4749.49,3,0,0,0,3,6.31646
50376,3593,31640.62,31640.62,29,0,1,0,30,9.48148
50378,4077.25,39326.81,37962.26,28,0,0,0,28,7.37575
50379,1159,16290.5,16290.5,10,0,0,0,10,6.13855
50382,2140,23568.03,23567.99,15,0,2,0,17,7.21317
50384,1462,29923.15,22003.2,8,0,1,0,9,4.09031
50387,2028.5,34731.97,32051.57,18,0,1,0,19,5.92795
50388,10380.13,153165.9,132988.81,73,0,4,0,77,5.78996
50389,3419,48199.98,45611.48,25,0,1,0,26,5.70032
50390,1662.25,21620.98,21620.97,10,0,1,0,11,5.08765
50391,23571.75,321000.41,248783.17,145,40,7,0,192,7.71756
50393,26253.5,409312.92,266955.06,136,8,10,0,154,5.76876
50394,27076,169254.14,140705.23,74,11,19,2,106,7.53348
50395,1159,19385.36,17028.43,9,0,0,0,9,5.28528
50397,898,50745.32,19764.65,6,0,0,0,6,3.03572
50398,2578,44518.06,40055.8,17,0,1,0,18,4.49373
50399,1876.25,22683.38,22683.36,13,0,0,0,13,5.73107
50400,26199.25,543801.87,341425.46,160,5,9,0,174,5.09628
50401,10042.75,160474.8,146136.21,67,0,4,0,71,4.85848
50402,39959.13,290576.48,280509.05,163,16,32,0,211,7.52204
50403,20861,204511,202353.35,117,6,8,0,131,6.47382
50405,819,39125.46,17454.54,6,0,0,0,6,3.4375
50407,25967.25,206643.29,167127.2,67,0,15,0,82,4.90644
50408,8046.38,55529.42,55529.42,25,0,6,0,31,5.58263
50409,10539,202964.64,77323.02,62,0,2,0,64,8.27697
50410,23545,291779.1,225625.58,137,48,15,0,200,8.86424
50411,14786.63,138848.32,102155.77,46,0,15,0,61,5.97127
50412,26963,264896.26,225724.31,204,0,10,1,215,9.52489
50413,8025,122002.84,101460.46,67,0,0,0,67,6.60356
50417,17030,143524.49,143524.44,103,14,11,0,128,8.91834
50419,23149,255335.14,253419.77,166,1,7,0,174,6.86608
50420,11213,195930.92,120173.38,56,0,3,0,59,4.90957
50421,1931,34031.46,20898.82,12,0,3,0,15,7.17744
50422,3100,120976.29,53983.63,8,0,3,0,11,2.03765
50423,10734.88,46231.48,46231.49,15,0,8,0,23,4.97496
50425,11507,174980.25,156147.38,71,0,1,0,72,4.61103
50426,2054,41038.61,29680.83,15,0,0,0,15,5.05377
50427,3752,26119.01,24699.69,24,0,1,0,25,10.1216
50428,4937.13,65381.43,61688.17,25,0,3,0,28,4.53896
50429,8263,105462.2,84575.54,60,3,0,0,63,7.44896
50430,258,4869.01,4869,3,0,0,0,3,6.16143
50431,12724.13,224972.75,199348.73,85,0,1,0,86,4.31405
50433,9992,116221.86,106003.36,69,10,0,0,79,7.45259
50435,4434,64745.26,52912.62,31,0,0,0,31,5.85872
50436,9698,302879.1,122866.64,60,0,1,0,61,4.96473
50437,6465,62214.47,62214.47,39,0,1,0,40,6.42937
50438,3645,75369.31,59639.46,21,0,1,0,22,3.68883
50442,1969,12481.6,12481.6,18,0,1,0,19,15.2224
50443,3090,76707.96,36888.32,26,0,0,0,26,7.0483
50444,34609.75,413768.33,387212.82,165,4,13,2,184,4.75191
50445,3658,50116.73,50116.73,20,0,0,0,20,3.99068
50446,7499.63,89749.26,74011.43,45,0,0,1,46,6.21526
50447,4339,153394.24,57551.68,34,0,0,0,34,5.90773
50448,3464,74474.71,52154.27,26,0,0,0,26,4.98521
50449,1918.25,91219.77,32668.86,13,0,0,0,13,3.97932
50450,4239,56478.73,56478.74,17,0,3,0,20,3.54116
50451,2439,27278.47,27278.49,11,0,1,0,12,4.39907
50452,6328,86330.5,82279.89,41,0,0,0,41,4.98299
50453,8567.63,195870.35,100903.83,58,2,4,0,64,6.34267
50454,6294,92134.33,80539.45,46,0,0,0,46,5.71149
50455,8088.5,63163.73,61414.12,50,0,5,1,56,9.11842
50456,5775,239731.24,73495.48,32,0,1,1,34,4.62613
50457,1433.88,45361.64,34983.1,12,0,1,0,13,3.71608
50461,1234.5,21071.44,21071.43,9,0,1,0,10,4.74576
50462,3022,71762.1,47599.63,19,0,0,0,19,3.99163
50463,4531.25,45724.54,39290.34,33,0,1,0,34,8.65353
50464,6341,57475.93,57475.93,39,0,2,0,41,7.13342
50467,5756,105374.4,80981.72,27,0,0,0,27,3.33409
50468,7532,88061.59,81681.87,47,2,3,0,52,6.36616
50469,1255,17222.93,17222.92,7,0,0,0,7,4.06435
50471,6908.38,75376.41,70394.76,98,0,2,0,100,14.2056
50472,1084,18904.25,18904.25,6,0,0,0,6,3.17389
50473,2654.63,39619.27,39619.25,20,0,2,0,22,5.55286
50474,7058.63,56774.38,56774.39,37,6,3,0,46,8.10225
50475,9224,82810.72,73021.63,41,0,5,2,48,6.5734
50476,1399.38,32592.42,32592.41,10,0,0,0,10,3.0682
50478,3459,45968.31,45968.32,26,0,1,0,27,5.87361
50479,900,18291.08,18291.09,7,0,0,0,7,3.827
50480,8866,126495.41,120268.38,59,0,4,0,63,5.23828
50481,18728,162369.67,162369.68,139,3,7,0,149,9.17659
50482,664,17747.77,9565.93,6,0,0,0,6,6.27226
50483,15978.25,124772.84,124772.81,73,0,4,1,78,6.25136
50484,64686.75,614021.04,468647.37,254,23,28,1,306,6.52943
50485,31807,327746.9,203997.62,75,0,19,2,96,4.70594
50486,7136.38,228036.66,133535.19,54,0,0,0,54,4.04388
50487,41437.13,791440.53,383973.73,169,3,19,1,192,5.00034
50488,5528,64184.52,64184.55,37,0,0,0,37,5.76463
50489,5206,36603.62,36603.63,39,0,0,0,39,10.6547
50490,10989,116979.14,100224.2,63,0,2,0,65,6.48546
50491,6553.63,73121.69,73121.71,31,0,2,1,34,4.64978
50492,33362.75,499496.22,452242.06,217,3,4,0,224,4.9531
50493,15609,214163.65,173990.59,97,0,8,0,105,6.03481
50495,112,4303.66,4303.66,1,0,0,0,1,2.3236
50496,6465.75,67983.57,67983.55,43,5,3,0,51,7.50181
50498,6653,83150.02,75566.47,45,0,2,0,47,6.21969
50499,3624.25,67524.06,67524.04,23,0,2,0,25,3.70239
50500,6465,165669.84,71934.68,41,0,1,0,42,5.83863
50502,203882.25,1093397.81,1071204.3,599,710,164,15,1488,13.8909
50503,6648.5,66000.7,66000.72,50,0,1,1,52,7.8787
50504,4013,158010.23,57965.03,16,0,0,0,16,2.76028
50505,9361.75,152967.48,121990.77,67,0,2,0,69,5.65617
50506,7769.25,114860.61,67485.55,58,0,1,0,59,8.74261
50507,2214.88,37012.1,35418.27,21,3,1,0,25,7.0585
50509,5320.38,120615.59,79443.71,24,0,6,0,30,3.77626
50510,5787.5,105543.62,94579.67,38,0,2,0,40,4.22924
50511,1702.5,33393.62,23711.85,13,0,0,0,13,5.48249
50512,3218,67040.14,51517.57,18,0,1,0,19,3.68806
50513,1244,19351.2,19351.2,9,0,0,0,9,4.65087
50514,2877.63,120106.91,54912.47,22,0,0,0,22,4.00638
50516,60644.25,289897.45,289897.37,209,3,47,0,259,8.9342
50517,820,21073.65,10931.17,6,0,0,0,6,5.48889
50518,2976,154150.73,49068.4,11,0,1,0,12,2.44557
50519,8815,93467.88,93467.89,65,0,2,0,67,7.16824
50521,1727,167632.82,26654.27,12,0,0,0,12,4.50209
50522,2804.88,37278.04,37278.03,20,0,1,0,21,5.63334
50523,36089.88,969677.63,292903.14,121,16,22,1,160,5.46256
50524,2169.63,60270.89,36326.94,16,0,0,0,16,4.40444
50525,3297.63,129338.52,24513.87,9,0,1,0,10,4.07932
50528,4351,65762.2,63636.8,24,0,0,0,24,3.7714
50529,255,5030.55,5030.55,1,0,0,0,1,1.98785
50531,8138.75,97639.83,85279.65,45,0,2,0,47,5.51128
50532,59278,516024.75,347533.32,294,101,32,1,428,12.3154
50533,1740,48511.59,29705.62,11,0,0,0,11,3.703
50535,10734,214456.01,174284.36,60,0,2,0,62,3.5574
50536,648,5596.58,5596.58,5,0,0,0,5,8.93402
50537,8056.75,46919.16,46919.15,51,0,4,0,55,11.7223
50538,5042,61196.14,61196.15,32,0,1,0,33,5.3925
50539,16832,170332.9,157190.96,76,10,13,1,100,6.36169
50540,9243.88,137264.13,134181.9,53,1,4,0,58,4.32249
50541,16025,133038.44,133038.41,119,8,7,0,134,10.0723
50542,3602.75,85384.19,72056.65,27,0,1,0,28,3.88583
50543,11954.63,103718.89,101778.43,80,0,9,0,89,8.74449
50546,29337.13,342142.2,318608.48,196,5,5,0,206,6.46562
50548,1171,16771.9,13310.84,9,0,0,0,9,6.7614
50549,3638.63,52087.67,48466.41,31,0,0,0,31,6.39618
50550,16425.63,169468.02,152072.59,104,5,11,0,120,7.89097
50551,21734.25,242070.48,204120.55,118,9,16,1,144,7.05465
50552,3278,49742.1,38714.72,20,0,0,0,20,5.16599
50553,5070,110942.94,72244.13,15,8,1,0,24,3.32207
50554,22943.13,153085.5,132583.05,139,6,15,0,160,12.0679
50556,8182,85403.49,85403.51,65,0,1,0,66,7.72802
50562,16306,88809.7,88809.69,102,15,19,1,137,15.4262
50563,1567,99780.16,38752.35,11,0,0,0,11,2.83854
50564,8523,187607.05,93295.67,58,0,2,1,61,6.53835
50565,47161.5,617024.02,436814.09,226,48,30,0,304,6.95948
50567,4214,77645.58,68591.8,26,0,0,0,26,3.79054
50568,4461,71937.7,66605.18,25,0,5,0,30,4.50415
50569,7170,116541.41,93766.49,48,0,2,0,50,5.3324
50570,717,37155.63,7337.63,7,0,0,0,7,9.53986
50571,245,5127.61,5127.62,2,0,0,0,2,3.90045
50572,1772.63,43924.85,35607.5,13,0,2,0,15,4.2126
50573,1393.75,29648.02,23429.34,11,0,0,0,11,4.69497
50574,2357,25293.14,25293.14,9,0,2,0,11,4.349
50575,8848.38,69190.53,69190.52,66,0,3,0,69,9.97246
50576,8431.13,85147.13,84208.79,73,2,2,0,77,9.14394
50577,2296.5,45874.14,45874.15,16,0,0,0,16,3.4878
50578,1588,28957.99,28957.99,10,0,0,0,10,3.45328
50579,8410.75,162620.46,159252.82,52,0,4,0,56,3.51642
50580,6690,102024.73,92309.64,48,0,0,0,48,5.19989
50581,5474.13,99064.04,95375.1,36,0,0,0,36,3.77457
50582,20404,232258.82,208946.09,110,10,10,0,130,6.2217
50583,2548.13,47809.76,42269.56,23,0,0,0,23,5.44127
50584,5227.88,75977.37,69688.63,29,0,2,0,31,4.44836
50585,23222,254665.69,248090.91,179,0,7,0,186,7.49725
50588,7202,123230.19,110543.01,48,0,1,0,49,4.43266
50589,1253,39912.48,24053.99,9,0,0,0,9,3.74158
50590,5131.13,101770.88,78641.9,40,0,0,0,40,5.08635
50591,20367,264318.67,136882.11,66,4,10,0,80,5.84445
50592,18581.63,194084.47,176553.56,109,21,10,0,140,7.9296
50593,6476,82340.77,82340.76,42,0,0,0,42,5.10075
50594,13355.25,166309.19,137103.18,88,0,4,0,92,6.71027
50596,2855.75,73313.4,68879.67,22,0,0,0,22,3.19398
50597,6468.5,238038.24,113596.11,39,0,2,0,41,3.60928
50598,1256,24946.38,19393.16,11,0,0,0,11,5.6721
50599,23269.5,260308.44,248898.66,137,0,7,0,144,5.78549
50601,63746.13,767955.17,576396.86,234,0,21,4,259,4.49343
50603,15100,107693.36,107693.39,130,0,7,0,137,12.7213
50604,15129,181837.91,157579.23,61,6,9,2,78,4.94989
50605,9322.75,176295.16,146409.3,62,0,7,1,70,4.78112
50606,4132,67695.31,67695.29,29,0,0,0,29,4.2839
50607,4102.75,81867.11,67328.34,27,0,1,0,28,4.15872
50609,685,9278.77,9278.78,5,0,0,0,5,5.38864
50610,1223,29108.69,21751.16,10,0,0,0,10,4.59746
50612,5544,114507.32,57841.02,44,0,0,0,44,7.60706
50613,3263,55208.24,55208.25,22,0,1,0,23,4.16604
50615,64327.5,451241.62,411030.99,270,113,60,5,448,10.8994
50616,21098.38,237215.05,186960.26,136,9,5,0,150,8.0231
50617,2769,77567.12,65616,18,0,1,0,19,2.89564
50618,2115,28546.45,28546.45,11,0,1,1,13,4.55398
50619,2418,53471.6,42996.51,18,0,1,0,19,4.41896
50621,496.75,4231.21,4231.21,3,0,0,0,3,7.09017
50622,5861.25,142667.1,103829.32,31,0,1,0,32,3.08198
50624,4619.25,62808.28,58842.7,32,0,1,0,33,5.60817
50626,3060,70895.24,48440.44,21,0,1,0,22,4.54166
50628,1265,17476.72,14785.33,7,0,0,0,7,4.73442
50629,10997,275716.16,142492.22,60,0,0,0,60,4.21076
50633,455,15386.47,11547.14,4,0,0,0,4,3.46406
50634,852,16422.23,16422.23,7,0,0,0,7,4.26252
50637,3341,31623.1,31623.1,21,0,2,0,23,7.27317
50639,24649.25,227674.59,202497.41,120,117,32,0,269,13.2841
50641,9621.63,139164.6,120734.83,55,0,3,0,58,4.80392
50643,10483,114840.02,89340.26,53,0,6,0,59,6.60397
50647,20044.5,107505.66,99786.67,117,0,6,0,123,12.3263
50648,8611,119272.03,85743.27,63,0,1,0,64,7.46414
61001,188673,769149.79,675914.51,390,491,234,5,1120,16.5701
61002,3328.38,69591,49735.97,39,5,0,0,44,8.84672
61005,3624.75,62170.23,51498.19,21,0,2,0,23,4.46618
61006,116473,577478.25,498843.42,179,263,95,8,545,10.9253
61007,38676.5,625063.95,438407.17,165,43,19,0,227,5.17783
61008,10983,69963.27,69963.29,31,5,6,1,43,6.14608
61010,780.625,81615,24749.25,7,0,1,1,9,3.63647
61011,4530,66041.43,62237.11,31,0,1,0,32,5.14163
61012,3292,40592.16,40592.16,27,0,0,0,27,6.65153
61013,685.625,53489,11431.22,6,0,1,0,7,6.12358
61014,659,7057.81,7057.8,5,0,0,0,5,7.08436
61015,3745,98955.09,33607.94,14,0,4,0,18,5.35588
61017,225,124252,10583.39,1,0,2,0,3,2.83463
61018,253.125,61252,9794.34,2,0,0,0,2,2.042
61020,379.375,10576,10508.18,3,0,0,0,3,2.85492
61021,548,12899.28,4996.25,4,0,0,0,4,8.00601
61023,4686,80766.83,70302.27,27,0,1,0,28,3.9828
61024,6826,137960.02,95259.37,55,0,2,0,57,5.98366
61026,811.5,23660.88,18936.96,7,0,0,0,7,3.69648
61028,4773.38,211013.96,77010.04,24,0,1,0,25,3.24633
61029,6878,95280.62,70182.08,24,2,7,2,35,4.98703
61030,2955,49013.26,48271.6,21,0,1,0,22,4.55755
61032,2658,63306.42,50006.37,17,0,2,0,19,3.79952
61034,1430,27332,27156.72,14,0,0,0,14,5.15526
61035,2533,160919.72,38438.58,10,0,0,0,10,2.60155
61036,607,8132.6,8132.6,5,0,0,0,5,6.14809
61037,500,17698.41,14670.17,3,0,0,0,3,2.04497
61038,18468,150888.65,102368.63,18,25,76,6,125,12.2108
61039,823.375,9501,9440.07,6,0,1,0,7,7.4152
61040,7042.75,282479.15,104085.27,52,1,3,0,56,5.3802
61041,1130,22224.75,18887.2,7,0,0,0,7,3.70621
61043,4078.75,60730,60340.52,25,0,12,0,37,6.13187
61044,3034,67005.5,42211.83,20,0,1,0,21,4.97491
61046,573.25,13839,5801.55,5,0,0,0,5,8.61838
61048,646,279838.93,13797.29,4,0,0,0,4,2.89912
61049,829,43517.02,13269.86,5,0,1,0,6,4.52153
61050,2209.5,60616.54,45849.21,14,0,0,0,14,3.05349
61051,2574.75,146123,52504.1,20,0,3,0,23,4.38061
61052,1169,56837.6,24638.43,8,0,1,0,9,3.65283
61053,1199.75,53810.32,23483.77,10,0,1,0,11,4.68409
61054,1004.63,49662,42697.44,12,0,1,0,13,3.04468
61055,3314,79020.82,56359.89,13,3,2,0,18,3.19376
61056,1045,146671.17,16549.92,6,0,1,0,7,4.22963
61060,1209,23378.51,17268.34,9,0,0,0,9,5.21185
61061,13770.63,290702.21,152682.05,64,3,9,0,76,4.97766
61063,12018,110806.25,110806.28,67,0,6,0,73,6.58807
61064,423.125,67228,3951.5,3,0,0,0,3,7.59206
61066,629,7840.56,7840.55,5,0,0,0,5,6.3771
61067,2147.38,56748.73,43046.5,12,0,0,0,12,2.78768
61068,476.375,11624,11549.45,6,0,0,0,6,5.19505
61069,754,11408.43,11408.43,3,0,1,0,4,3.50618
61070,39451,351690.72,253287.89,40,3,11,0,54,2.13196
61071,932.625,140677,20931.4,7,0,4,0,11,5.25526
61072,729.375,39147,23028.35,7,0,0,0,7,3.03973
61074,3431.75,85765,35878.42,20,3,10,0,33,9.19773
61075,14595,346666.71,171026.55,72,5,6,0,83,4.85305
61076,1336.25,202154,34104.87,7,0,0,0,7,2.05249
61077,30493,199817.55,155766.42,55,0,28,0,83,5.32849
61078,6587,135046.69,91023.27,35,2,5,0,42,4.6142
61079,7250.88,67948.41,49867.49,35,2,4,0,41,8.22179
61080,100,390,387.499,0,0,1,0,1,25.8065
61081,11402.25,320880.82,147472.6,71,0,5,0,76,5.1535
61082,253.375,3798,3773.64,3,0,0,0,3,7.94988
61084,68.75,2926.9,2926.9,1,0,0,0,1,3.41658
61085,276.875,11551,11476.92,2,0,1,0,3,2.61394
61086,1293.63,73585,36664.1,13,0,0,0,13,3.5457
61087,725,16433.36,12284.65,5,0,0,0,5,4.07012
61089,251.875,6514,6472.22,3,0,0,0,3,4.63519
61091,6745,284417.03,101005.06,22,2,5,0,29,2.87114
61092,5933.63,75464.9,73695.12,43,0,4,1,48,6.51332
61093,8971,106399.03,98844.03,59,0,2,0,61,6.17134
61094,3308,31596.79,31596.78,26,0,0,0,26,8.22869
61095,6460,94316.89,82109.1,41,0,0,0,41,4.99336
61096,24678.25,348872.69,236114.77,123,4,11,2,140,5.92932
61097,11995,73539.25,73539.24,8,0,8,0,16,2.17571
61098,5841,78513.78,57395.74,39,0,2,0,41,7.14339
61099,734,11766.96,9997.51,4,0,2,0,6,6.00149
61100,2780,52845.84,49566.35,16,0,1,0,17,3.42975
61101,1910.13,31899,31694.43,20,0,0,0,20,6.31026
61102,6570,84190.11,77042.26,32,0,0,1,33,4.28336
61103,2896,88077.51,46431.98,6,0,1,0,7,1.50758
61104,162,1557.87,1557.88,1,0,1,0,2,12.838
61105,504,6482.99,6482.99,4,0,0,0,4,6.16999
61107,2898,63959.47,41421.37,14,0,1,0,15,3.62132
61108,1331,91942.37,28342.33,7,0,2,0,9,3.17546
61111,1848,30517.75,30517.75,13,0,1,0,14,4.58749
61114,1660,24932.54,18649.84,11,0,1,0,12,6.43437
61116,12364,168676.82,155666.04,77,4,5,0,86,5.52465
61117,53975,551312.6,236646.38,171,1,84,0,256,10.8178
61118,740,12446.33,12446.34,6,0,0,0,6,4.8207
61120,166.875,5602,5566.08,2,0,0,0,2,3.59319
61121,1116,6824.86,6824.86,6,0,2,0,8,11.7219
61122,884,30289.75,27440.83,2,0,1,0,3,1.09326
61123,1490.63,31792,31588.11,14,0,0,0,14,4.43205
61124,3718,85002.53,62872.1,26,4,1,0,31,4.93064
61126,5021,76977.39,57020.11,24,0,1,1,26,4.55979
61129,4845,122255.58,58920.17,22,0,3,0,25,4.24303
61130,3577.88,274746.73,50163.85,23,1,0,0,24,4.78432
61133,3471,62224,52256.7,29,0,4,0,33,6.31498
61137,1111,18695.17,18695.17,7,0,0,0,7,3.74428
61138,3827,122477.03,60254.67,10,0,2,0,12,1.99155
61139,2828.5,105881,55154.01,26,0,0,1,27,4.89538
61140,16002,131979.31,97905.51,35,2,2,0,39,3.98343
61141,4183,58218.1,39071.99,29,0,1,0,30,7.67813
61142,557,62220.99,15440.69,2,0,1,0,3,1.94292
61143,20107,115461.29,107398.21,47,6,27,1,81,7.54203
61145,30687.88,344681.28,273151.67,159,22,20,2,203,7.43177
61146,3800,46826.54,34209.78,29,0,0,0,29,8.47711
61148,3132.13,76845.04,42498.65,25,1,2,0,28,6.58844
61149,1500.25,28864.87,21248.55,12,0,0,0,12,5.64744
61150,6090,79293.98,69924.49,18,0,8,0,26,3.7183
61151,3704,74474.65,59516.64,21,0,2,0,23,3.86447
61152,226.875,14812,6829.91,2,0,0,0,2,2.92829
61153,9670.25,177334,119377.93,83,8,7,1,99,8.29299
61156,2393.38,169968,51314.78,32,0,1,0,33,6.4309
61158,168,1967.63,1967.63,0,0,1,0,1,5.08225
61159,0,753,748.171,0,0,1,0,1,13.3659
61160,991,17137.46,17137.51,2,0,1,0,3,1.75055
61162,714.875,27123.23,13513.73,5,0,0,0,5,3.69994
61163,14213.13,125934.53,122244.69,44,4,11,1,60,4.90819
61164,2119,33315.86,30769.26,14,0,2,0,16,5.2
61165,6919.13,182902.13,83311.66,49,0,4,0,53,6.36165
61166,517.375,9124,9065.48,5,0,0,0,5,5.51543
61167,23682,516421.08,323399.32,146,25,9,0,180,5.56587
61168,33065.75,357704.41,276570.01,104,16,26,0,146,5.27895
61169,107621.13,747587.49,565949.24,265,261,120,5,651,11.5028
61170,686.25,29204,14734.89,6,0,0,0,6,4.07197
61171,367.25,4824,4793.06,2,0,0,0,2,4.1727
61172,1047,33855.1,29084.99,5,0,0,0,5,1.7191
61173,7335,332597.44,60885.88,3,0,6,1,10,1.64242
61176,789.625,58180,14105.96,7,0,0,0,7,4.96244
61178,238,10135.8,4363.8,1,0,0,0,1,2.29158
61180,151.75,3620,3000.63,1,0,0,0,1,3.33263
61181,12128,64786.8,64786.84,51,26,4,1,82,12.6569
61182,3740,94713.71,58716.01,22,4,2,0,28,4.76872
61187,1004.63,41615.22,21812.51,8,0,0,0,8,3.66762
61188,80.625,1496,1486.41,1,0,0,0,1,6.72764
61189,2538.38,64397.55,50443.65,19,0,1,0,20,3.96482
61192,510,12887.94,10645.74,4,0,0,0,4,3.75737
61193,1896,168629.67,34122.87,13,0,0,0,13,3.80976
61194,5686,100814.67,59014.3,29,0,2,0,31,5.25296
61195,1398.5,31020.56,13762.59,7,0,1,0,8,5.81286
61196,14009,493905.92,147430.39,54,1,9,0,64,4.34103
61197,536,10810.93,10810.92,3,0,0,0,3,2.77497
61198,354.875,34296,11651.63,3,0,0,0,3,2.57475
61199,1703,39179.73,35027.08,8,0,1,0,9,2.56944
61202,7377,264322.25,102673.62,37,0,4,0,41,3.99324
61203,8816,420436.47,105993.48,53,2,3,0,58,5.47203
61206,1155.5,50072,19301.42,12,0,0,0,12,6.21716
61207,6006.63,54215.22,54215.26,18,0,7,0,25,4.61125
61208,7752,141099.94,109127.51,47,0,4,0,51,4.67343
61209,1260,40803.9,16393.09,6,0,3,1,10,6.10013
61210,1718.5,51728,48162.92,15,0,1,1,17,3.52969
61211,20047.38,343129.4,244254.49,109,0,12,1,122,4.99479
61212,783,13308.9,11972.13,7,0,0,0,7,5.84691
61213,1649,82912.65,37944.92,9,0,0,0,9,2.37186
61214,49098,331411.59,275943.84,172,208,61,0,441,15.9815
61215,1359.88,15913.98,15913.98,10,0,0,0,10,6.28379
61216,1829.63,206676,38690.28,15,0,0,0,15,3.87694
61218,12088.13,103736.15,94755.48,55,0,14,0,69,7.2819
61219,1064,21030.25,21030.25,5,0,1,1,7,3.32854
61221,2150,56252.13,34225.59,19,0,0,0,19,5.5514
61222,10486.38,128097.9,114005.45,33,1,6,1,41,3.59632
61224,5073.25,98212.38,70000.25,31,0,0,0,31,4.42856
61225,195,366,363.652,1,0,0,0,1,27.4988
61227,1084,64344.85,20722.94,8,0,0,0,8,3.86046
61228,1059,44793.84,14897.08,7,0,0,0,7,4.69891
61229,593,10464.02,10464.01,5,0,0,0,5,4.77828
61230,28143.88,758195,348102.3,141,9,27,0,177,5.08471
61231,831,12430.61,12430.61,4,0,1,0,5,4.02233
61232,9809.25,132354.81,113482.62,53,3,3,0,59,5.19903
61233,2293,127274.7,34307.64,17,0,0,0,17,4.95516
61234,14484.63,115386.21,98909.31,81,0,6,1,88,8.89704
61237,1192.63,47986,22507.72,10,0,1,0,11,4.88721
61238,78.75,877,871.376,1,0,0,0,1,11.4761
61240,2072,34029.47,18879.61,9,0,1,0,10,5.29672
61241,2658.75,47793,38047.42,26,0,0,0,26,6.83358
61242,1078.25,33351,25162.59,11,0,0,0,11,4.37157
61243,16535,232838.04,197220,81,0,4,1,86,4.36061
61244,896.125,50327,33110.53,9,0,0,0,9,2.71817
61248,7526,59882.17,45315.2,21,0,6,0,27,5.95827
61251,480,14374.3,14374.3,3,0,0,0,3,2.08706
61252,279,6005.95,6005.95,2,0,0,0,2,3.33003
61255,1017,14461.46,14461.46,4,3,3,0,10,6.91493
61256,444,7685.17,7685.17,3,0,0,0,3,3.90362
61257,572,6224.62,6224.61,4,0,0,0,4,6.42611
61258,5122,25190.11,25190.1,16,11,6,0,33,13.1004
61259,191,20696.8,6575.98,2,0,0,0,2,3.04137
61260,5425.5,134179.01,98441.77,43,0,1,0,44,4.46965
61261,947,101921.7,12450.99,4,0,0,0,4,3.2126
61262,606.5,24027,13918.16,7,0,0,0,7,5.0294
61263,1357,22858.32,22858.32,7,0,1,0,8,3.49982
61264,90,1700,1689.1,1,0,0,0,1,5.92032
61265,764,22767.05,22767.04,6,0,0,0,6,2.63539
61266,523.75,7153,7107.13,4,0,0,0,4,5.62815
61267,1587.88,32274.62,27834.04,14,0,0,0,14,5.02981
61268,918,15990.45,9169.62,4,0,0,0,4,4.36223
61269,4037,56554.53,56554.5,27,0,1,0,28,4.95098
61271,400.625,19768,8174.24,4,0,0,0,4,4.89342
61273,64,11280.1,2478.22,1,0,0,0,1,4.03515
61274,1206.38,25558,25394.09,12,0,0,0,12,4.72551
61275,7180,141603.01,80199.79,31,9,20,0,60,7.48132
61276,280.25,6561,2639.96,2,0,0,0,2,7.57587
61277,2202,154389.72,39328.88,14,1,1,0,16,4.06826
61278,19733.75,226329.82,199892.01,129,1,4,0,134,6.70362
61279,3885,31451.06,31451.05,30,0,0,0,30,9.53863
61281,1568.75,43695,36691.18,13,0,0,0,13,3.54309
61283,1053,30231,21012.38,9,0,1,0,10,4.7591
61284,611,21374.07,12922.62,5,0,0,0,5,3.86918
61285,3451.75,70407,65678.07,34,0,0,0,34,5.17677
61286,339,4485.73,4485.73,0,0,1,0,1,2.22929
61287,4882,65981.14,62263.28,26,1,2,0,29,4.65764
61288,4621.25,110371,78708.47,44,0,1,0,45,5.7173
61289,286.25,32013,8684.94,2,0,1,0,3,3.45425
61290,335,14823.22,4533.04,2,0,0,0,2,4.41205
61291,100,8515,921.054,0,0,1,0,1,10.8571
61292,6942.75,253653.03,142700.9,29,3,7,0,39,2.73299
61293,28803,148406.22,146777.6,135,32,28,2,197,13.4217
61294,6387.88,75860.48,62208.16,52,0,5,1,58,9.32354
61295,1063.88,19112.68,19112.68,8,0,0,0,8,4.1857
61297,4762,155653.14,42220.69,18,0,3,1,22,5.21072
61298,1056,21409.9,15979.12,9,0,0,0,9,5.63235
61299,1444.75,53116,35258.43,15,0,0,0,15,4.2543
61300,2020.13,58499.08,27296.08,12,2,2,0,16,5.86165
61301,1725.13,68243.79,24510.32,11,0,0,1,12,4.8959
61302,354.375,21628,9466.9,3,0,0,0,3,3.16894
61303,5045.25,82799.8,65229.18,42,0,1,1,44,6.74545
61304,3349,70858.09,45663.8,22,0,0,0,22,4.81782
61307,930,26229.64,22204.76,7,0,0,0,7,3.15248
61308,465,5458.89,5458.89,3,0,0,0,3,5.49562
61309,11138.88,304102,229273.14,112,0,6,1,119,5.19032
61310,3209.25,60690.02,37480.7,19,0,2,0,21,5.60288
61311,415.5,27703,5840.3,4,0,0,0,4,6.84896
61314,5486.5,230347.15,56108.98,30,0,1,0,31,5.52496
61316,764,84366,13121.31,6,0,1,0,7,5.33483
61317,781,49955.53,12084.97,4,0,0,0,4,3.3099
61319,675.5,14012,13922.14,6,0,0,0,6,4.30968
61321,2210,21208.92,21208.93,18,0,0,0,18,8.48699
61322,737.875,13971.95,13971.94,6,0,0,0,6,4.29432
61323,779.375,29196,16688.29,8,0,0,0,8,4.79378
61324,7788.88,120348.99,79962.41,41,7,5,0,53,6.62811
61326,1265,11357.91,11357.91,10,0,4,0,14,12.3262
61327,1873.5,49465.75,13587.69,2,3,0,0,5,3.6798
61328,402.75,31624,10940.38,4,0,3,0,7,6.39832
61329,7310,275889.17,66046.36,45,0,2,0,47,7.11621
61330,166,8024.25,2979.68,1,0,0,0,1,3.35606
61331,722.75,29750,18189.59,7,0,0,0,7,3.84835
61332,1645,31146.77,31146.79,10,0,1,1,12,3.85272
61333,271,5829,5791.62,1,0,0,1,2,3.45327
61336,1953,44270.36,17604.99,1,0,3,0,4,2.27208
61339,18041.88,329414.75,230835.54,84,2,8,0,94,4.07216
61341,19612.88,239331.69,195070.32,78,0,7,1,86,4.40867
61342,6012,80660.17,52998.79,47,0,0,0,47,8.86813
61344,7861.63,72524.71,69741.78,54,6,3,0,63,9.03332
61345,14603.38,194769.87,170633.08,70,1,12,0,83,4.86424
61346,575,56920,16455.51,6,0,0,0,6,3.6462
61347,494,15100.91,15100.92,4,0,0,0,4,2.64885
61348,2405,55389.8,34962.02,15,0,0,0,15,4.29037
61349,474,9715.88,5788.21,3,0,0,0,3,5.18295
61350,792,10010.91,9221.98,3,0,0,0,3,3.2531
61351,1435.63,156961,35204.97,11,0,0,0,11,3.12456
61352,1174,35366.94,10149.76,0,0,1,0,1,0.985245
61357,271.25,46137,3494.45,4,0,0,0,4,11.4467
61358,1086,26297.26,12850.31,6,0,0,0,6,4.66915
61360,43,26080,2136.21,0,0,0,0,0,0
61361,1030.13,37208.7,31186.71,6,0,0,0,6,1.9239
61362,7034.25,103562.65,86675.87,27,1,3,0,31,3.57654
61363,472.125,13297.94,8609.07,3,0,0,0,3,3.4847
61365,3049,124248.38,34655.06,18,0,2,0,20,5.77116
61366,105,22013,6366.69,2,0,0,0,2,3.14135
61367,326,2985.14,2985.15,1,0,1,1,3,10.0498
61369,10835,365108.94,140940.57,68,6,3,1,78,5.53425
61370,1344.38,36922.73,26995.35,5,1,1,0,7,2.59304
61371,178.75,2957,2938.03,2,0,0,0,2,6.80727
61372,72,72.9995,72.9995,1,0,0,0,1,136.987
61373,1839,39016.29,26703.3,12,0,1,0,13,4.86831
61374,321.25,7874,7823.5,3,0,0,0,3,3.8346
61375,10047,231963.77,129130.74,67,0,1,0,68,5.26598
61376,7782.13,122426.94,119208.41,47,2,1,0,50,4.19433
61379,586.5,18799,16879.05,5,0,2,0,7,4.14715
61382,6451,80166.64,65246.22,38,6,2,0,46,7.05022
61383,513,8276.96,8276.96,3,0,0,0,3,3.62452
61384,843,106275.6,21164.56,6,0,0,0,6,2.83493
61385,4038,199340.33,74426.11,28,0,0,0,28,3.76212
61386,3103,176655.11,40605.34,27,0,0,1,28,6.89564
61387,4593.75,76530.52,34994.22,21,0,4,0,25,7.14404
61388,683,12519.08,12519.08,3,0,0,0,3,2.39634
61389,3445,197551.55,33256.65,17,0,1,1,19,5.71314
61390,348,3897.86,3897.87,3,0,0,0,3,7.69652
61391,28798,270159.53,177282.89,155,87,11,0,253,14.271
61392,533.875,22677,17037.04,5,0,0,0,5,2.93478
61393,727,28418.6,16780.45,5,0,0,0,5,2.97966
61394,2881,66824.86,54888.32,19,0,2,0,21,3.82595
61395,873.875,37548.57,29815.45,7,0,0,0,7,2.34778
61396,1287,4328.42,4328.42,1,0,2,0,3,6.93094
61397,32665.5,296444.11,276800.45,196,37,25,0,258,9.32079
61399,110.625,6000,3348.38,1,0,0,0,1,2.98651
61400,2783,51912.15,24751.61,22,0,2,1,25,10.1004
61401,1567,49682.36,31823.76,8,0,0,0,8,2.51385
61402,2068.63,76894.16,40541.4,11,0,1,0,12,2.95994
61403,1764,83756.61,25506.27,10,0,0,0,10,3.92061
61404,11897,94764.08,80402.38,47,0,11,0,58,7.21372
61405,1759.38,25950.45,17788.87,13,0,1,0,14,7.87009
61406,1073,17450.05,17450.04,7,0,0,0,7,4.01145
61407,4777,70584.71,70584.77,31,0,3,0,34,4.8169
61408,1584,38439.98,31691.46,11,0,0,0,11,3.47097
61411,1194,38659.94,23549.2,7,0,1,0,8,3.39714
61412,4846,62973.91,58751.08,19,9,6,0,34,5.78713
61413,206.25,3770,3745.82,2,0,0,0,2,5.33928
61414,18569,162452.91,162452.89,44,5,12,0,61,3.75493
61415,4326,176035.05,68127.19,18,0,3,1,22,3.22925
61418,1504,32201.98,19532.47,10,0,0,0,10,5.11968
61419,1056.88,13677,12068.11,6,0,0,0,6,4.97178
61420,241.875,5242,5208.38,2,0,0,0,2,3.83996
61421,4523,359974.13,64149.56,24,0,1,1,26,4.05303
61422,7637,192934.27,87558.26,30,4,5,2,41,4.6826
61423,6046.88,87363.49,72677.53,47,2,0,0,49,6.74211
61424,1646.5,167021,22904.16,13,0,2,0,15,6.54903
61425,611.75,13182.11,8660.05,3,0,0,0,3,3.46418
61426,2300.25,31608.64,31608.63,11,0,1,0,12,3.79643
61427,417.125,75414,8844.91,5,0,0,0,5,5.65297
61429,4254,88521.54,45780.41,30,6,1,0,37,8.08206
61432,1219.5,41054.74,30427.6,8,0,1,0,9,2.95784
61433,1549,52912.25,29570.28,10,0,0,0,10,3.38177
61435,2137,117905.7,53986.47,13,0,0,0,13,2.40801
61436,1479,36905.93,36905.95,13,0,0,0,13,3.52247
61438,997,162558.94,24732.71,6,0,1,0,7,2.83026
61439,1033,15797.48,15797.44,0,0,1,0,1,0.633014
61440,24982.75,164108.37,141085.59,51,0,14,0,65,4.60713
61442,1545.38,27501.64,27501.65,10,0,0,0,10,3.63615
61443,6233.13,99306.93,87926.4,38,4,9,0,51,5.80031
61444,1649,48467.46,30541.05,4,0,2,0,6,1.96457
61445,3261.88,62239,49062.32,31,0,1,0,32,6.52232
61446,402,114021.92,6644.34,3,0,0,0,3,4.51512
61447,15409,160597.93,135454.62,68,76,12,0,156,11.5168
61448,2826.75,61347,55816.72,23,0,1,0,24,4.29979
61450,1001.75,231116.49,16873.74,3,0,0,0,3,1.77791
61451,3233.5,115555,63213.48,27,0,0,0,27,4.27124
61452,1696,121915.57,28725.48,9,0,0,0,9,3.13311
61453,838,19177,12358.24,6,0,2,0,8,6.47342
61454,3159.5,95111.94,46460.47,17,0,4,0,21,4.51997
61456,46552,299200.99,273805.04,102,7,29,1,139,5.0766
61457,23905,147867.76,127228.99,29,2,4,1,36,2.82954
61459,3794,139882.36,63564.09,18,0,3,0,21,3.30375
61460,3750.63,113822,68551.53,25,11,10,0,46,6.71028
61461,1013,104272.85,12515.74,2,0,2,1,5,3.99497
61462,38682,294595.81,271502.75,68,0,8,1,77,2.83607
61463,22772.5,525091.19,253840.03,138,0,8,2,148,5.83044
61464,33796,449593.37,228101.49,72,138,40,5,255,11.1792
61466,13196,105493.21,102907.78,92,1,2,0,95,9.23157
61467,2808,117693.05,46977.89,15,0,2,0,17,3.61872
61468,741,13248.26,7353.11,3,0,1,0,4,5.43987
61472,1477,17742.36,17742.34,8,0,1,0,9,5.07261
61473,1978.25,33180,32967.21,19,0,2,0,21,6.36997
61474,20594.5,541027.68,321637.46,169,0,7,1,177,5.50309
61475,4752,130146.71,63548.59,35,0,1,0,36,5.66496
61476,1688,28614.82,25648.96,14,0,0,0,14,5.45831
61479,562,13911,11193.75,4,0,1,0,5,4.46678
61480,1606,34363.04,34363,7,0,2,0,9,2.6191
61481,244.75,4500,4471.14,2,0,0,0,2,4.47313
61482,4243.75,50994.48,50994.48,31,0,0,0,31,6.07909
61483,17754.13,366620.22,188419.64,77,99,13,0,189,10.0308
61484,36852.13,435033.66,227943.64,90,2,11,1,104,4.56253
61485,846.875,30026,21646.29,9,0,0,0,9,4.15776
61486,21549.25,485898.4,389624.81,158,12,17,1,188,4.82515
61487,2612.63,44358.11,35844.93,15,0,1,0,16,4.46367
61488,246,3234.52,3234.51,2,0,0,0,2,6.18331
61490,1459,29033,28846.81,11,0,1,1,13,4.50656
61491,13960.38,336093,229206.56,150,18,10,0,178,7.76592
61492,460.375,27778,11662.72,3,0,1,0,4,3.42973
61493,2826,415063.4,50370.97,1,0,13,0,14,2.77938
61494,9172,44731.75,44731.74,40,0,4,0,44,9.83642
61497,30523,414839.83,193375.37,83,22,34,0,139,7.18809
61498,507,3155.6,3155.61,3,0,0,0,3,9.50689
61499,986,123133.09,11318.78,7,0,0,0,7,6.18441
61500,90.625,3119,3099,1,0,0,0,1,3.22685
61501,749.375,15219,15121.4,7,0,0,0,7,4.6292
61502,391,12783.38,6173.37,2,0,0,0,2,3.23972
61503,391,97504,13178.93,4,0,1,0,5,3.79393
61505,740.75,17441,10192.21,4,0,1,0,5,4.90571
61507,2097,40158.94,31043.24,15,0,0,0,15,4.83197
61508,16889,208404.15,132413.11,54,36,13,0,103,7.77869
61510,3127,53406.92,40809.89,16,0,1,0,17,4.16566
61512,526,7744.64,7744.64,0,0,2,0,2,2.58243
76001,11409.13,124437,105307.54,97,2,3,0,102,9.68592
76002,4798.38,124483.4,122248.68,50,0,4,0,54,4.41723
76004,3495.63,41426.35,41426.38,21,1,2,0,24,5.79341
76005,14758,87563.1,84005.93,106,172,5,1,284,33.8071
76006,1494.38,20800.29,20800.27,13,0,0,0,13,6.24992
76007,3375,37074.72,37074.88,22,0,0,0,22,5.93394
76008,3767.38,30646.35,30646.36,29,0,4,0,33,10.768
76009,2518.38,31947.32,31947.28,23,0,0,0,23,7.19936
76010,2523.25,35299.16,35299.22,21,0,0,0,21,5.94914
76011,1196.5,17544.89,17544.87,8,0,1,1,10,5.69967
76012,1036,18252.8,18252.88,6,0,0,0,6,3.28715
76013,10234.88,145277.59,138526.59,67,7,1,0,75,5.41412
76014,9186,104518.6,92700.69,52,4,4,0,60,6.47244
76015,3421.13,59051.25,39284.02,22,0,0,0,22,5.60024
76016,717,13123.23,13123.27,6,0,0,0,6,4.57203
76017,6344.25,89194.05,81549.43,22,0,2,0,24,2.943
76018,10869.38,158467.2,151613.71,78,1,6,0,85,5.60635
76019,2641,54077.43,39686.78,18,0,1,0,19,4.78749
76020,11527.5,155746.78,103242.17,86,0,4,0,90,8.71737
76021,5344.5,62914.04,62913.99,47,0,0,0,47,7.47052
76022,755,19801.67,11972.08,4,0,0,0,4,3.34111
76023,1745.63,32037.78,32037.89,16,0,0,0,16,4.99409
76024,864,15668.09,15668.07,6,0,0,0,6,3.82944
76025,1787,9852.51,9852.51,8,0,1,0,9,9.13472
76026,42272.13,186229.99,167985.2,32,46,18,3,99,5.89338
76028,1488,28043.83,26128.46,10,0,0,0,10,3.82724
76029,714.25,13843.88,11332.54,6,0,0,0,6,5.29449
76030,4019.25,46877.38,46877.57,27,0,2,0,29,6.18633
76032,1746,36249.43,22562.43,10,0,0,0,10,4.43215
76033,3679.63,44555.7,44555.64,32,0,0,0,32,7.18203
76034,17189.38,147114.15,147114.14,98,21,14,0,133,9.0406
76035,13354.25,61494.03,61494.01,12,16,10,1,39,6.34208
76036,5392.88,67284.3,67284.35,43,0,2,0,45,6.68803
76038,3075.63,51100.75,41368.26,23,0,0,0,23,5.55982
76039,8814.38,88145.55,62357.49,44,0,1,0,45,7.21645
76040,1348.25,24225.08,24225.02,11,0,1,0,12,4.95356
76041,4032.88,56941.11,56941.1,25,0,3,0,28,4.91736
76042,248,3701.87,3701.85,2,0,0,0,2,5.4027
76043,8967.88,127186.05,83407.01,80,0,2,0,82,9.83131
76045,2916.5,80499.25,60554.95,26,5,0,0,31,5.11932
76046,4137.13,47658.77,47658.79,37,0,0,0,37,7.76352
76047,1197.38,12621.14,12621.16,4,0,0,0,4,3.16928
76048,1437.75,31979.96,22022.68,8,0,0,0,8,3.63262
76049,1042,14969.29,14969.3,9,0,0,0,9,6.0123
76050,6887.25,97712.23,88321.33,69,0,2,0,71,8.03883
76051,8281.88,93657.2,82898.91,45,9,7,0,61,7.35836
76052,1517.13,17625.02,17624.91,11,0,0,0,11,6.24117
76053,224,3020.56,3020.56,2,0,0,0,2,6.62128
76054,1246,204311.29,18639.35,11,0,0,0,11,5.90149
76055,1319.13,16662.2,16662.18,13,0,0,0,13,7.8021
76056,4198,87099.4,49127.22,39,1,0,0,40,8.14213
76057,118912.26,558092.62,547212.03,268,131,54,0,453,8.27833
76058,998.75,10623.8,10623.78,9,0,0,0,9,8.47156
76059,4780.75,62973.89,56352.98,31,0,0,0,31,5.50104
76060,3708.38,56130.54,56130.67,31,0,0,0,31,5.52283
76062,2020,37495.57,35512.15,15,0,0,0,15,4.22391
76063,4294.5,67284.16,65662.53,35,0,0,0,35,5.33028
76064,5319.88,48496.95,48496.83,36,0,0,0,36,7.42317
76065,2264.88,29816.48,29816.48,23,0,0,0,23,7.71386
76066,2130.5,12439.5,12439.47,8,0,1,0,9,7.23504
76067,5113.63,81927.93,81928.04,39,9,0,0,48,5.8588
76068,3964.38,83451.14,48136.39,32,0,0,0,32,6.64778
76069,16328.63,124184.59,88783.15,81,6,3,0,90,10.1371
76070,1619,28462.65,28462.66,14,0,2,0,16,5.6214
76071,1848.38,30546.19,30546.16,15,0,0,0,15,4.9106
76072,12830.13,208226.74,150250.95,89,0,3,0,92,6.12309
76075,1852.38,22010.05,22010.01,16,0,0,0,16,7.26942
76076,2770,40468.79,28873.05,15,0,0,0,15,5.19516
76077,1259.5,40869.37,27523.85,10,0,0,0,10,3.63321
76079,1727.75,17278.25,17278.29,18,0,0,0,18,10.4177
76082,6512,132422.77,84491.26,37,0,1,0,38,4.49751
76083,313.625,5917.99,5917.99,3,0,0,0,3,5.06929
76084,707.25,8573.12,8573.09,9,0,0,0,9,10.498
76085,1461.38,35020.86,35020.9,12,0,0,0,12,3.42653
76086,3033.38,46669.65,40503.4,15,0,0,0,15,3.70339
76087,2710.38,47709.31,47709.39,28,0,1,0,29,6.07847
76088,3859.25,45275.57,41789.51,17,0,1,0,18,4.3073
76090,6415.75,71053.51,71053.42,49,0,1,0,50,7.03696
76091,2421,34017.77,34017.8,19,0,0,0,19,5.58531
76092,3247,26584.17,26584.27,24,0,0,0,24,9.0279
76093,2935.75,72426.39,48696.66,28,0,0,0,28,5.74988
76094,1361,31207.6,26081.62,10,0,0,0,10,3.83412
76095,17374.75,101570.36,82739.39,50,49,11,0,110,13.2948
76096,7461,119686.55,94743.03,47,0,1,0,48,5.06634
76097,932,28159.87,9830.98,5,0,1,0,6,6.10315
76099,3611.13,63989.65,54543.27,21,0,3,0,24,4.40018
76100,8315,140583.76,107913.94,54,1,1,1,57,5.28199
76101,17518.38,113895.56,113895.44,103,25,11,0,139,12.2042
76103,8471,36452.29,36452.32,27,110,4,1,142,38.955
76104,982,11777.52,11777.58,7,0,0,0,7,5.9435
76105,14427,98263.34,77159.26,20,0,1,0,21,2.72164
76106,3800.75,49337.52,49337.58,28,0,0,0,28,5.67519
76107,4835.25,81343.26,70198.89,32,1,2,0,35,4.98583
76108,78608.75,516055.99,447797.8,253,307,74,1,635,14.1805
76109,1783.13,67153.17,64798.64,9,1,2,0,12,1.85189
76110,2589.38,38537.48,38537.56,31,0,0,0,31,8.0441
76111,2427.63,26793.62,26793.66,20,0,0,0,20,7.46445
76112,2330.25,49340.58,30029.98,19,0,1,0,20,6.66001
76113,3259.63,39318.22,39318.15,29,0,0,0,29,7.37573
76114,32644,255344.91,188192.49,99,179,31,1,310,16.4725
76115,5468.13,70939.93,55267.09,35,0,0,0,35,6.33288
76116,35090.63,231369.52,215947.76,268,0,11,0,279,12.9198
76117,8418.5,204263.16,108344.4,52,0,1,0,53,4.89181
76118,894,12834.91,12834.85,3,0,0,0,3,2.33739
76119,644,19403.78,8926.77,4,0,0,0,4,4.4809
76120,1825.88,55090.34,28862.9,13,0,0,0,13,4.50405
76121,2109.75,35073.66,27223.14,19,0,0,0,19,6.97936
76122,5523,90660.53,79599.13,24,3,5,0,32,4.02014
76123,9955,149893.08,98631.82,60,0,0,0,60,6.08323
76124,3243.38,57374.22,57374.13,25,0,0,0,25,4.35736
76125,7026,60237.56,60237.76,34,12,5,0,51,8.46645
76126,2420.63,35537.01,26568.24,19,0,0,0,19,7.1514
76128,2932.63,61518.04,50393.45,22,0,1,0,23,4.56409
76129,977.875,15028.34,11412.3,10,0,0,0,10,8.76248
76130,3179.63,29214.88,29214.91,14,0,1,0,15,5.13437
76131,782,6555.55,6555.53,3,16,0,0,19,28.9832
76132,3038.88,41125.78,41125.72,30,0,0,0,30,7.29471
76133,1906.38,41984.83,38065.17,12,0,1,0,13,3.4152
76134,767.75,13279.43,13279.47,13,0,0,0,13,9.78955
76135,5108.25,63949.69,59133.89,34,3,1,0,38,6.42609
76136,10491.63,73743.44,70499.41,57,0,5,0,62,8.7944
76138,7501.13,156301.46,74379.44,14,0,3,0,17,2.28558
76139,2387.25,47226.63,45346.89,16,0,0,0,16,3.52836
76140,1118.13,16445.48,16445.43,7,0,0,0,7,4.2565
76141,15123.38,228190.93,122970.59,86,0,7,0,93,7.56278
76142,3285.38,72349.07,49800.75,22,0,0,0,22,4.4176
76143,11194.13,112260.9,112260.97,61,2,13,0,76,6.76994
76144,1090,36295.8,23522.25,6,0,0,0,6,2.55078
76146,20246.25,174996.25,152633.18,93,58,17,1,169,11.0723
76147,5951.38,128326.37,80788.61,39,0,3,0,42,5.19875
76148,1358.5,15867.36,15867.28,12,0,0,0,12,7.56273
76149,1662.38,23737.19,23737.17,12,0,0,0,12,5.05536
76151,1873,38684.13,34959.78,14,0,0,0,14,4.0046
76152,2839.63,45878.18,28433.86,19,8,1,0,28,9.84741
76153,1350,23670.41,23670.4,16,0,0,0,16,6.7595
76154,629,9733.8,9733.85,7,0,0,0,7,7.1914
76155,2076.25,25463.2,25463.28,17,0,0,0,17,6.67628
76156,3306.5,31605.61,31605.42,23,0,0,0,23,7.27723
76157,75775,309599.64,272524.79,223,680,34,1,938,34.4189
76158,3611,66018.78,54371.1,26,0,1,0,27,4.96587
76159,8075.75,61014.29,61014.39,43,74,6,0,123,20.1592
76160,4860.25,72242.77,68215.69,39,0,0,0,39,5.71716
76161,243.875,3911.14,3911.12,2,0,0,0,2,5.11363
76162,2114.88,70352.5,44058.6,19,0,0,0,19,4.31244
76163,2149.13,42918.08,27298.08,10,5,0,0,15,5.49489
76164,20995.5,233746.24,216548.58,65,79,21,0,165,7.61954
76165,46671,251517.82,219885.06,206,283,18,1,508,23.103
76166,3481.63,43904.43,43904.52,30,0,0,0,30,6.83301
76167,16000,137129.84,130132.58,81,0,3,0,84,6.45496
76168,589.5,8314.55,8314.55,5,0,0,0,5,6.01356
76169,8625.75,114836,107009.29,67,0,0,0,67,6.26114
76170,1737.13,42001.61,28935.56,11,0,0,0,11,3.80155
76171,1949,41532.57,41532.68,13,0,0,0,13,3.13007
76172,692,15861.97,15862.07,5,0,0,0,5,3.15217
76173,5215.63,117412.97,67897.48,46,0,0,0,46,6.77492
76174,1771.38,39406.85,36528.24,18,0,1,0,19,5.20146
76175,1446.13,22629.16,22629.21,12,0,2,0,14,6.1867
76176,3020.13,31086.74,31086.74,29,0,1,0,30,9.65042
76177,1435.5,17211.25,17211.27,12,0,0,0,12,6.97218
76178,18847,87530.99,85390.38,87,46,24,0,157,18.3861
76179,8385.13,144956.22,90476.27,39,40,1,0,80,8.8421
76180,2257.13,35458.75,35458.69,17,0,0,0,17,4.79431
76181,2863,40774.2,40774.22,4,0,1,0,5,1.22627
76182,3138.63,35469.37,35469.44,11,0,1,0,12,3.38319
76183,5993.75,84012.72,69611,37,3,7,0,47,6.75181
76184,121.25,1701.73,1701.75,1,0,1,0,2,11.7526
76185,547,7066.09,7066.03,5,0,0,0,5,7.07611
76186,7017,97969.15,82119.83,29,0,6,0,35,4.26206
76187,315.625,2823.53,2823.53,2,0,0,0,2,7.08332
76188,3172.13,43678.84,43678.88,32,0,1,0,33,7.55514
76189,2012,17319.19,17319.18,11,0,0,0,11,6.35134
76190,503,6603.45,6603.45,4,0,0,0,4,6.05744
76191,3761.88,73694.66,56676.65,26,0,0,0,26,4.58743
76192,26719.88,224338.72,220761.06,186,190,13,0,389,17.6209
76193,2449.88,56772.45,42073.76,20,0,0,0,20,4.75356
76194,378,3221.6,3221.59,4,0,0,0,4,12.4162
76195,1510.5,25968.02,25968.23,16,0,0,0,16,6.16137
76196,25647.88,206279.92,178251.34,107,85,11,1,204,11.4445
76197,2655.63,65251.64,65251.91,22,1,7,0,30,4.59757
76198,6871.13,112372,112372.33,53,0,3,0,56,4.98343
76199,6258.38,117774.63,83968.99,41,0,1,0,42,5.00185
76200,1900.5,19616.97,19617.07,17,0,0,0,17,8.66592
76201,2471.13,50099.2,24866.81,22,12,0,0,34,13.6728
76202,3181.88,43720.12,43720.09,31,0,0,0,31,7.09056
76203,3648.13,41511,41510.94,36,0,0,0,36,8.67241
76204,1761,30466.22,29385.04,18,0,0,0,18,6.12557
76205,10135,49962.74,49962.67,7,0,7,0,14,2.80209
76206,2570.88,47279.11,41632.77,19,0,0,0,19,4.56371
76207,852.625,20536.07,13749.47,7,0,0,0,7,5.09111
76208,7405.38,151768.91,102941.02,48,6,0,0,54,5.24572
76209,4044.5,80574.65,60665.34,33,0,1,0,34,5.60452
76210,2586,22117.58,22117.63,19,0,0,0,19,8.59043
76211,1199.25,31529.93,19899.07,6,0,1,0,7,3.51775
76212,40068,159575.9,159575.82,101,389,21,0,511,32.0224
76213,1759,18478.41,18478.46,12,0,0,0,12,6.49405
76214,1854.13,25940.18,25940.21,16,0,0,0,16,6.16803
76216,25559,79196.3,74365.73,38,466,19,3,526,70.7315
76217,75595.5,371056.9,329143.72,238,845,74,3,1160,35.243
76218,255,2205.47,2205.46,1,0,0,0,1,4.5342
76219,16015.75,236157.74,182352.93,80,46,11,0,137,7.5129
76220,3104.38,53642.84,53079.21,26,0,0,0,26,4.89834
76221,2694,62143.73,51495.69,18,0,0,0,18,3.49544
76222,19177.5,155418.69,146197.25,121,78,9,0,208,14.2274
76223,3415.75,37546.67,35132.48,31,0,0,0,31,8.82374
76224,6532,114272.8,69117.01,34,0,2,0,36,5.20856
76225,1321.38,16055.3,16055.29,8,0,1,0,9,5.60563
76226,2259,28150.7,28150.62,18,0,0,0,18,6.39417
76227,5738.38,88953.75,88954.03,45,0,3,0,48,5.39605
76228,1731.38,16354.8,16354.75,14,0,0,0,14,8.5602
76229,2554.13,37217.34,37217.37,21,0,0,0,21,5.64253
76230,4536.88,74718.12,69331.53,33,6,0,0,39,5.62515
76231,49858,207950.52,194936.44,242,818,20,0,1080,55.4027
76232,3570.38,40117.23,40117.19,38,6,1,0,45,11.2171
76233,794,20261.28,13564.68,7,0,0,0,7,5.16046
76234,2494.13,42544.29,39956.02,23,0,0,0,23,5.75633
76235,9688.5,114438.57,101562.76,60,29,5,0,94,9.25536
76236,821.625,18047.36,18047.37,9,0,0,0,9,4.98688
76237,3184,30586.53,29724.84,24,0,0,0,24,8.07405
76238,14219.75,147696.1,118204.56,40,2,18,0,60,5.07595
76239,4771.88,369213.23,49483.54,22,0,2,0,24,4.8501
76240,24458.13,205040.59,205040.75,61,0,8,0,69,3.36518
76241,368,7408.99,7408.96,2,0,0,0,2,2.69943
76242,670,17750.02,17750.01,5,0,0,0,5,2.8169
76243,2928.88,41860.23,41860.35,25,0,1,0,26,6.21113
76244,3262.88,56725.5,42604.77,27,0,1,0,28,6.57203
76245,17984.25,139633.9,125341.32,69,1,21,0,91,7.26018
76247,4699,114409.41,50171.11,30,0,2,0,32,6.37817
76249,8212.5,103769.88,103036.43,76,0,2,0,78,7.57014
76250,5981.5,140041.13,89106.72,38,3,0,0,41,4.60122
76251,2179.75,62348.28,39779.13,16,0,0,0,16,4.02221
76252,12497.88,98104.25,98103.99,43,2,13,0,58,5.91209
76253,7779.75,133984.13,103319.64,59,12,1,0,72,6.96867
76254,1742.75,37434.61,19249.85,7,3,1,0,11,5.71433
76255,42482.63,243464.04,197639.53,114,98,34,0,246,12.4469
76257,1126.13,19736.22,19736.25,11,0,0,0,11,5.5735
76258,32091,422461.74,334062.71,183,102,9,0,294,8.80074
76259,81071.63,384633.6,357163.39,184,610,94,4,892,24.9746
76260,11434.75,81583.38,81583.35,52,11,9,1,73,8.9479
76261,3423.25,99492.6,62977.99,27,1,0,0,28,4.446
76262,700.875,17859.75,17859.83,5,0,0,0,5,2.79958
76263,8650.63,176756.71,126332.39,54,0,6,0,60,4.74938
76264,2366,24965.95,24965.91,15,0,1,0,16,6.40874
76265,513,16367.74,9750.26,3,0,0,0,3,3.07684
76266,9378,60524.85,46783.87,56,0,3,0,59,12.6112
76268,627,13857.29,13857.28,4,0,0,0,4,2.88657
76269,1393.88,16016.58,16016.53,12,0,0,0,12,7.49226
76270,11129.75,101600.12,101599.94,70,3,0,0,73,7.18504
76271,8593.5,83252.68,83252.63,86,0,1,0,87,10.4501
76272,1321,12760.58,12760.62,12,0,0,0,12,9.40393
76273,1803,16994.11,16994.08,13,0,0,0,13,7.64972
76274,195,1618.9,1618.93,1,0,0,0,1,6.17691
76275,3541.5,33830.29,28461.13,21,0,0,0,21,7.37848
76276,25144.38,271106.85,237151.02,88,128,21,1,238,10.0358
76278,3699.13,41889,34850.01,7,10,8,0,25,7.1736
76279,1881.13,40775.47,40775.46,10,0,4,0,14,3.43344
76280,326.5,7499.75,6362.99,3,0,0,0,3,4.71477
76281,21923.13,200605.17,186070.94,138,20,7,0,165,8.86759
76282,1681,30307.24,26396.44,15,0,0,0,15,5.68258
76283,2685,111879.97,42666.98,19,0,1,0,20,4.68747
76284,3143.25,37076.64,37076.57,26,0,0,0,26,7.01251
76285,5587.5,62158.62,62158.73,41,0,0,0,41,6.59602
76286,6733,217216.31,75310.89,35,0,2,0,37,4.91297
76287,5859,69358.41,69358.42,43,0,0,0,43,6.19968
76288,2228.75,47342.24,33325.92,21,0,0,0,21,6.3014
76289,11701,159767.83,151752.2,102,4,8,1,115,7.57814
76290,2604,47147.72,47147.6,17,0,1,0,18,3.8178
76291,5105.25,49511.57,49511.74,33,5,3,0,41,8.28086
76292,1251,18325.06,18325.04,9,0,1,0,10,5.45701
76293,1384.75,22984.49,22984.46,12,0,0,0,12,5.22092
76294,1339.25,29163.59,29163.56,12,0,1,0,13,4.45762
76295,6027.38,65760.79,46169.47,33,3,9,0,45,9.7467
76296,24043.5,161139.36,159681.7,146,0,11,0,157,9.83206
76297,1113.75,17675.47,17675.5,10,0,0,0,10,5.65755
76298,2768.13,34137.51,34137.51,25,0,1,0,26,7.61626
76299,3821.38,51822.66,48956.71,32,0,1,0,33,6.74065
76300,4035,29532.17,29532.18,17,0,1,0,18,6.09505
76302,16582,118947.15,118947.33,72,133,8,0,213,17.9071
76303,4482,43740.32,43740.43,25,0,2,0,27,6.17278
76304,3230,85876.19,52479,17,0,0,0,17,3.23939
76305,166066.51,2311539.78,1044421.47,144,141,81,14,380,3.63838
76306,1221.63,17968.88,17968.86,12,0,0,0,12,6.67822
76307,5302,59257.24,56120.79,21,31,4,0,56,9.97848
76308,5660.63,91707.3,91707.35,44,0,0,0,44,4.79787
76309,230.125,2268.18,2268.14,2,0,0,0,2,8.81779
76311,924.875,29424.73,14191.08,8,0,0,0,8,5.63734
76312,39174.25,269187.67,269187.51,224,121,26,0,371,13.7822
76313,4754.13,50445.65,50445.55,29,11,0,0,40,7.92934
76314,4826.63,60351.86,60351.85,34,0,0,0,34,5.63363
76315,6454.63,81247.4,68010.59,50,7,0,0,57,8.38105
76316,1179.13,111959.38,13109.69,10,0,0,0,10,7.62794
76317,2360.5,69909.57,69909.64,18,0,2,0,20,2.86084
76318,2953.75,57174.64,38173.7,18,0,0,0,18,4.71529
76319,90361.38,462332.97,428528.97,297,54,41,0,392,9.14757
76320,1968.88,28906.19,25874.1,18,9,0,0,27,10.4351
76321,7904.25,114223.88,84726.72,39,5,8,0,52,6.13738
76322,200150.75,766402,688754.88,163,407,81,2,653,9.48088
76323,1295,22831.42,22831.47,13,0,0,0,13,5.6939
76324,5702.13,33384,33384.01,36,0,3,0,39,11.6822
76325,2222.25,39750.86,37781.98,14,0,1,0,15,3.97015
76327,2914.25,30497.67,30497.75,22,0,0,0,22,7.21365
76328,3047.38,117855.88,75714.49,22,0,3,0,25,3.30188
76329,41738.25,224029.5,205204.96,203,57,22,0,282,13.7424
76330,5882.88,79014.55,72566.99,33,0,2,0,35,4.82313
76331,2758.25,37121.35,30861.75,28,0,0,0,28,9.07272
76332,4407,37491.96,37491.92,42,0,0,0,42,11.2024
76333,3323.5,32258.17,32258.28,25,2,1,0,28,8.67994
76334,3056.75,44312.5,35698.69,18,2,4,1,25,7.00306
76335,829.75,5726.65,5726.61,6,0,0,0,6,10.4774
76336,3170.13,51580.13,51580.21,24,0,0,0,24,4.65295
76338,1136.75,19890.31,16355.14,14,0,1,0,15,9.17143
76339,1794,20201.7,15754.09,19,0,0,0,19,12.0604
76340,3605.25,57092.74,47289.81,28,0,0,0,28,5.92094
76341,40111.5,239921.91,193931.03,66,140,45,1,252,12.9943
76342,4320.5,65085.04,55102.87,35,0,0,0,35,6.35176
76343,1600,15876.89,15876.91,10,0,0,0,10,6.29846
76344,2058.75,34319.21,32154.96,18,0,0,0,18,5.59789
76345,1757.5,23036.88,23036.82,10,0,1,0,11,4.77496
76346,2392.63,43578.09,37575.13,16,5,0,0,21,5.5888
76347,3018.25,50524.87,50524.89,19,0,0,0,19,3.76052
76348,4249,48693.05,48692.92,36,0,1,0,37,7.59864
76349,9077.13,109750.49,94913.15,51,8,6,0,65,6.84837
76350,2514,24141.78,22521.7,18,0,0,0,18,7.99229
76351,573108.26,3494852.82,2078682.22,952,5315,808,45,7120,34.2525
76352,2262.25,26442.91,25387.99,17,0,1,0,18,7.08997
76354,5486.25,56378.07,54741.38,39,0,0,0,39,7.12441
76355,3351.38,94215.08,45483.69,27,2,1,0,30,6.59577
76356,811.875,8113.7,8113.69,7,0,0,0,7,8.62739
76357,1727,31780.54,23072.13,6,3,0,0,9,3.90081
76358,1431.38,22832,22831.99,10,0,1,0,11,4.8178
76359,1289,21820.68,21820.66,10,2,1,0,13,5.95766
76360,4207,109426.42,69893.01,30,0,0,0,30,4.29228
76361,4462.13,75749.94,50913.04,27,1,2,0,30,5.8924
76362,2830.38,54448.39,54448.24,24,0,0,0,24,4.40786
76363,3107.38,43356.66,43356.67,27,0,1,0,28,6.45806
76364,3204.63,85524.16,48465.58,29,0,0,0,29,5.98363
76365,1146,7024.47,7024.44,13,0,0,0,13,18.5068
76366,16426,68887.22,67214.66,15,81,8,1,105,15.6216
76367,19836.88,151874.34,150716.81,145,4,1,0,150,9.95244
76368,3146.75,42978.71,37539.08,19,4,0,0,23,6.12695
76369,3420,90825.87,66339.83,21,0,3,0,24,3.61774
76370,3705.63,41069.53,41069.68,28,0,1,0,29,7.06117
76371,467.625,5198.79,5198.82,4,0,0,0,4,7.69405
76372,3951.88,44039.98,41747.68,26,0,2,0,28,6.70696
76373,1667.38,23789.92,23789.87,10,1,1,0,12,5.04416
76374,1256.25,13794.72,13794.78,14,0,0,0,14,10.1488
76375,1894.63,34238.83,24157.62,12,0,0,0,12,4.96738
76377,46551,307608.61,295856.94,181,13,61,2,257,8.68663
76378,8730,142425.57,109192.11,52,4,5,0,61,5.58648
76379,996.375,10567.32,10567.35,7,0,0,0,7,6.62418
76380,1827.63,33848.35,24279.6,13,0,0,0,13,5.35429
76381,754.875,19726.56,19726.6,5,0,0,0,5,2.53465
76382,7385.88,81861.17,65970.1,48,0,3,0,51,7.73078
76383,877,12835.6,12835.61,9,0,0,0,9,7.01174
76384,55316.13,247273.35,239647.45,39,113,36,3,191,7.97004
76385,6562.88,85038.2,69062.18,57,0,1,0,58,8.39823
76386,1741,33991.88,29184.72,12,0,0,0,12,4.11174
76387,2263.5,25030.47,25030.52,21,0,1,0,22,8.78927
76388,5809,74358.25,58415.51,19,0,1,0,20,3.42375
76389,429.375,5925.9,5925.86,4,0,0,0,4,6.75008
76390,6185.75,124799.74,68993.97,39,2,4,0,45,6.52231
76391,22404,235306.62,178501.9,146,4,5,1,156,8.7394
76392,11444.63,95378.69,95378.82,88,13,3,0,104,10.9039
76394,5283.75,36437.85,36437.95,23,0,3,0,26,7.13542
76395,3673.88,74596.43,57480.51,38,0,0,0,38,6.61094
76396,1170,29400.51,24083.1,7,15,0,0,22,9.13504
76397,7065,47937.99,47937.96,65,0,2,0,67,13.9764
76398,1832.63,34268.83,27775.21,15,0,0,0,15,5.4005
76399,680,12995.13,12995.13,5,0,0,0,5,3.8476
76400,11657.88,100989.85,100989.81,57,3,11,0,71,7.03041
76401,14822.88,235575.24,189218.56,120,1,4,0,125,6.60612
76402,24052,178632.02,162724.46,157,61,2,0,220,13.5198
76403,1113.63,10007.87,10007.82,4,4,0,0,8,7.99375
76404,9354.75,118076.6,92961.15,61,0,2,0,63,6.77702
76405,1844.38,94212.84,24962.14,14,0,0,0,14,5.60849
76406,6490.38,75654.51,73883.03,39,64,0,0,103,13.941
76407,1953.63,23023.43,23023.34,12,0,1,0,13,5.64644
76408,5212,75146.23,74702.14,51,0,2,0,53,7.09484
76409,5900.38,143544.1,50955.58,44,0,1,0,45,8.83122
76410,17650,60209.92,54541.61,28,98,18,0,144,26.4019
76411,2033.88,46387.33,46387.43,6,0,4,0,10,2.15576
76412,5292.88,54751.61,54751.55,40,0,2,0,42,7.67102
76413,563,5405.54,5405.46,5,0,0,0,5,9.2499
76414,17172.88,121894.9,121314.45,92,43,16,0,151,12.447
76415,3104.38,65384.35,47818.11,18,0,2,0,20,4.18252
76416,5923.5,71253.15,71253.34,34,0,1,1,36,5.05239
76417,3257,42740.84,42740.67,24,0,2,0,26,6.0832
76418,6792.38,71305.07,71305.09,52,0,3,0,55,7.71333
76419,610.25,13561.54,11567.54,4,0,0,0,4,3.45795
76420,10923,434631.55,110634.97,20,0,3,0,23,2.07891
76421,2829.13,74447.67,41095.01,18,2,2,0,22,5.35345
76422,1383.75,14256.09,11859.96,13,0,0,0,13,10.9613
76424,2065.5,22863.97,22863.99,19,0,0,0,19,8.31001
76425,3613,41658.71,41658.72,22,0,0,0,22,5.28101
76426,1677,74616.73,35399.34,13,0,1,0,14,3.95488
76427,8549.13,176193.2,92958.33,57,2,1,1,61,6.56208
76428,114,2783.11,2783.09,1,0,0,0,1,3.59313
76429,73391,344457.55,341644.38,467,561,34,2,1064,31.1435
76430,350.5,9193.05,5952.65,3,0,0,0,3,5.03977
76431,1161,26182.52,18922.29,10,0,1,1,12,6.34173
76432,1985,83240.23,28809.53,12,0,0,0,12,4.16529
76433,5717.38,121952.34,81625.38,39,0,0,0,39,4.77793
76434,7825.88,126086.07,85370.23,58,4,1,0,63,7.37962
76435,7724.88,120015.74,88651.98,65,0,5,0,70,7.89604
76436,4754,210799.1,84975.17,40,0,0,0,40,4.70726
76437,8114.25,103210.69,103210.55,62,0,0,0,62,6.00714
76438,1935.13,28570.5,19938.89,15,0,0,0,15,7.52299
76439,957.5,11794.08,11794.12,8,0,0,0,8,6.78304
76440,1436.63,37780.25,19958.4,11,0,0,0,11,5.51146
76441,4678.38,37200.4,37200.3,30,0,3,0,33,8.8709
76442,4874.13,59574.8,59574.88,40,0,2,0,42,7.04995
76443,2483.13,49017.02,35469.97,18,0,0,0,18,5.07472
76445,3677.38,60056.35,47135.41,27,0,0,0,27,5.72818
76446,2676.13,26033.5,26033.55,16,0,0,0,16,6.14591
76447,55385.13,377992.75,342309.06,145,345,37,2,529,15.4539
76448,8075.88,56363.45,54366.68,75,0,0,1,76,13.9791
76449,5146.63,79540.43,63999.19,36,0,0,0,36,5.62507
76450,639,7452.79,7452.76,6,0,0,0,6,8.05071
76451,70050,359899.81,269333.4,93,195,91,2,381,14.146
76452,25303.75,205246.23,205246.35,182,51,5,0,238,11.5958
76453,4745.88,57708.6,57708.55,32,0,1,0,33,5.71839
76454,4492,208937.7,33685.55,4,0,3,0,7,2.07804
76455,2544,37028.77,37028.75,22,0,0,0,22,5.94133
76456,3287.63,38437.62,38437.51,28,0,1,0,29,7.54471
76457,4730.25,48679.8,41799.57,42,12,0,0,54,12.9188
76458,866.25,19126.72,14432.42,8,0,0,0,8,5.54308
76459,1471.38,23405.37,23405.29,8,0,3,0,11,4.69979
76460,1638,27003.91,26184.41,14,0,1,0,15,5.7286
76461,5708.63,144394.35,76786.53,36,0,1,0,37,4.81855
76462,37076.25,209623.69,209623.52,85,132,40,3,260,12.4032
76463,2253,34442.56,30493.81,16,2,0,0,18,5.90284
76464,26122,320400.32,220437.64,161,15,2,0,178,8.07485
76465,1810,57691.88,27447.2,16,0,0,0,16,5.82937
76467,7483.63,81944.19,81944.37,72,0,0,0,72,8.78645
76468,11645.88,136318.28,114369.74,96,1,4,0,101,8.83101
76469,4196.38,62990.08,62990.12,37,0,0,0,37,5.87394
76470,4406,59998.65,56413.75,42,0,0,0,42,7.44499
76471,4498.75,63869.17,63869.11,36,0,2,0,38,5.94967
76472,5687.5,83217.14,83217.3,49,0,0,0,49,5.8882
76473,10134.75,253704.22,140888.08,52,3,3,0,58,4.11674
76474,27330,127980.32,127979.96,111,290,10,2,413,32.2707
76475,72279.38,373086.08,362943.36,396,225,37,0,658,18.1296
76476,61782.51,430052.07,430051.98,404,75,23,1,503,11.6963
76477,2364.5,35680.8,34261.56,13,2,0,0,15,4.37808
76478,1201.38,25431.1,20849.15,12,0,0,0,12,5.75563
76479,877,9414.61,9414.61,9,0,0,0,9,9.55961
76480,1750.5,27835.55,27835.55,14,0,0,0,14,5.02954
76481,68264.38,560723.75,540093.16,325,52,18,0,395,7.31355
76482,9513.63,150798.35,99361.32,48,0,14,0,62,6.23985
76483,3613.13,66609.41,66609.47,30,0,1,0,31,4.65399
76484,75394,702620.15,646013.92,250,124,12,0,386,5.9751
76485,1321.63,14995.62,14995.59,6,0,3,0,9,6.00176
76486,522,4268.68,4268.67,5,2,0,0,7,16.3985
76487,1250.38,57434.21,21592.6,14,0,0,0,14,6.4837
76488,4493.13,124536.75,50155.3,29,0,1,0,30,5.98142
76489,101979.13,322007.45,321211.81,32,0,9,1,42,1.30755
76490,8514,143395.33,121336.82,61,8,2,0,71,5.85148
76491,6694.88,137933.06,117119.04,46,0,1,0,47,4.01301
76492,216,2895.93,2895.89,2,0,0,0,2,6.90634
76493,3769.13,155395.4,59815.31,24,1,2,0,27,4.51389
76494,4952,96499.85,61187.32,35,0,0,0,35,5.72014
76495,33929.75,296527.39,236997.05,227,126,10,2,365,15.401
76497,24071,91691.97,91692.11,131,342,17,2,492,53.6578
76498,100661.38,342554.32,296421.77,162,844,53,6,1065,35.9285
76499,8997.25,146839.09,94646.01,75,0,2,0,77,8.13558
76500,2902.13,62518.03,31179.36,16,0,1,0,17,5.45232
76501,1439.13,35613.42,25837.78,11,0,0,0,11,4.25733
76502,3184.63,48048.12,33271.49,27,0,0,0,27,8.11506
76503,7044.13,62088.84,59478.14,33,0,4,0,37,6.22077
76504,632.625,9009,9008.97,7,0,0,0,7,7.77003
76505,536.875,22315.1,13690.27,6,0,0,0,6,4.38267
76506,3870.88,46616.36,46616.51,25,0,1,0,26,5.57742
76507,4492.25,58545.97,32109.52,22,0,2,0,24,7.47442
76508,4451.13,63806.24,46553.77,19,0,0,0,19,4.0813
76509,14966.88,163957.46,149519.9,67,0,9,0,76,5.08294
76510,1896.38,36709.61,36709.5,16,0,0,0,16,4.35854
76511,314,7286.21,7286.14,3,0,0,0,3,4.11741
76512,796,4353.63,4353.61,2,0,0,0,2,4.59389
76513,979.875,14686.22,13202.73,6,2,0,0,8,6.05935
76514,3470.75,35427.44,33270.52,29,0,3,0,32,9.61812
76515,4164.63,41954.92,41954.88,32,4,1,0,37,8.819
76516,3185,47179.72,29891.04,13,0,1,0,14,4.68368
76517,19109.88,284934.24,156384.04,100,3,5,0,108,6.90608
76518,2530.88,33056.87,33056.89,19,0,0,0,19,5.74767
76519,146,11853.47,7785.27,2,0,0,0,2,2.56896
76520,3341.13,46295.15,46295.17,23,0,2,0,25,5.40013
76521,1319.5,23281.3,23281.26,9,0,0,0,9,3.86577
76522,8604.75,166764.79,92892.95,56,0,0,0,56,6.02844
76523,1051.5,15156.03,15156.09,9,0,0,0,9,5.93821
76524,292.5,3383.03,3383.04,3,0,0,0,3,8.86776
76526,785,10354.06,10354.12,9,0,0,0,9,8.69219
76527,1875.88,26229.35,22566.97,16,0,0,0,16,7.09001
76528,5784,68529.12,68529.05,35,0,1,0,36,5.25325
76529,2198.75,41531.59,36898.98,22,0,0,0,22,5.96222
76530,1081,19787.94,19788.01,8,0,0,0,8,4.04285
76531,3580.5,46214.59,42077.83,18,0,0,0,18,4.27779
76532,6338.88,73923.04,64660.94,45,0,1,0,46,7.11403
76533,16699.38,137224.82,137225.22,14,0,11,3,28,2.04044
76534,2259,31065.29,20236.11,12,12,0,0,24,11.86
76535,5032,119119.03,69196.44,22,0,2,0,24,3.46839
76536,4249,31640.12,31640.2,38,3,0,0,41,12.9582
76537,849.75,15851.59,15851.64,7,0,1,0,8,5.0468
76538,1491.88,52679.97,45648.81,13,0,0,0,13,2.84783
76540,290111.63,653721.62,650749.29,225,5958,372,20,6575,101.037
76541,14620.38,110580.63,110580.71,75,2,11,0,88,7.95799
76542,1811.5,26067.88,26068,12,0,0,0,12,4.60334
76543,5398,85773.27,78124.04,36,3,0,0,39,4.99206
76544,1496.63,30142.77,28159.8,16,0,0,0,16,5.68186
76545,29344.88,284981.69,239968.54,108,57,20,2,187,7.79269
76546,1936,26702.7,26702.66,17,0,0,0,17,6.36641
76547,16478.63,223257.86,163618.39,115,0,6,0,121,7.39526
76548,7597.88,46607.41,46607.33,58,1,2,0,61,13.0881
76549,729.5,16889.99,16889.99,7,0,1,0,8,4.73653
76550,7533,159690.06,63959.09,47,0,7,0,54,8.4429
76551,3942.38,53605.81,53605.9,20,0,1,1,22,4.10403
76552,10930.38,45342.18,45342.1,51,166,9,0,226,49.8433
76553,1341.13,28328.95,21118.75,12,0,0,0,12,5.68215
76554,999.5,19380.32,17039.6,9,0,0,0,9,5.28181
76555,4674.13,61566.13,59439.8,34,0,0,0,34,5.72007
76556,5376.13,145571.2,92476.55,48,4,0,0,52,5.62305
76557,6375.5,161609.7,103034.52,48,1,6,0,55,5.33802
76558,2630.5,38233.7,37603.08,27,0,1,0,28,7.4462
76559,3183.63,48252.31,44968.03,30,0,0,0,30,6.67141
76560,8166.38,63367.94,59712.74,58,0,3,0,61,10.2156
76561,48687,282121.79,217563.3,94,227,25,3,349,16.0413
76562,6439.5,106268.35,63854.84,42,0,9,0,51,7.98687
76563,10742.25,126908.37,123727.04,62,0,1,0,63,5.09185
76564,481.5,5731.92,5731.92,4,0,0,0,4,6.97847
76565,15078.38,226861.98,121286.45,43,21,15,0,79,6.51351
76566,1589.25,31479.03,31479.04,12,12,0,0,24,7.62412
76567,1720,43194.31,33405.2,6,0,0,0,6,1.79613
76568,6567.88,84465.21,68757.9,53,0,2,0,55,7.99908
76569,1696.63,44666.81,29808.18,8,0,0,0,8,2.68383
76570,6659.25,45628.54,45628.59,11,0,1,0,12,2.62993
76571,4969.38,77011.39,75872.27,32,2,0,0,34,4.48122
76573,1178.88,32228.29,22927.5,8,0,0,0,8,3.48926
76574,9235.13,158695.65,128657.26,80,0,1,0,81,6.2958
76575,173762,845101.39,843005.36,594,1332,72,7,2005,23.784
76576,2314.88,40504.14,34704.05,10,0,1,0,11,3.16966
76577,5464.63,82216.17,71335.53,48,0,1,0,49,6.86895
76578,444,8902.29,8902.33,2,0,0,0,2,2.2466
76580,6564.63,114642,79390.59,42,0,1,0,43,5.41626
76581,3221,52516.45,43644.92,19,0,0,0,19,4.35331
76582,2580.75,53030.66,33956.47,17,1,1,0,19,5.5954
76583,4967.25,66223.35,62122.46,43,0,0,0,43,6.92181
76584,555.625,4608.49,4608.53,5,0,0,0,5,10.8495
76585,5304,85471.93,69394.97,39,0,1,0,40,5.76411
76586,3298.88,80851.77,38999.26,22,0,0,0,22,5.64113
76587,3261.88,55998.35,55998.37,24,0,0,0,24,4.28584
76588,1871.75,33486.99,33487.09,21,0,1,0,22,6.5697
76589,1423.75,21218.83,21218.84,12,0,0,0,12,5.65535
76590,2336.75,31089.3,30037.1,18,0,0,0,18,5.99259
76591,21996,233417.66,159426.24,93,5,29,0,127,7.96607
76592,70511.88,185320.82,178182.94,15,0,4,0,19,1.06632
76593,10038,102080.77,91229.28,26,0,8,0,34,3.72687
76594,31451.25,315534.97,202570.22,48,0,54,1,103,5.08466
76595,9154,162492.27,133253.37,60,0,7,1,68,5.10306
76596,7447.5,62554.82,62554.66,63,0,0,0,63,10.0712
76597,5777.63,80276.97,70276.67,22,10,4,0,36,5.12261
76598,6715.75,76564.27,58374.68,30,0,2,0,32,5.48183
76599,16451,90474.66,90474.64,108,59,3,0,170,18.7898
76600,38761,565683.5,283844.82,59,14,41,0,114,4.01628
76602,9804.38,211336.81,122946.57,47,0,5,1,53,4.31082
76603,3419,57095.83,57095.93,21,0,0,0,21,3.67802
76604,1061.25,44353.52,26006.88,11,0,0,0,11,4.22965
76605,3992.75,56692.82,48578.95,28,0,2,0,30,6.17551
76606,909.875,8831.3,8831.28,7,0,0,0,7,7.92637
76608,21399.5,295146.38,199546.3,153,0,1,1,155,7.76762
76609,4691.63,63558.08,49161.84,29,0,2,0,31,6.3057
76610,15875,158256.84,133213.24,40,5,38,0,83,6.23061
76611,2479.5,36863.47,36863.39,16,0,0,0,16,4.34035
76612,1456.25,51845.12,35363.31,16,0,1,0,17,4.80724
76613,3358.13,50209.35,47797.39,27,2,0,0,29,6.06728
76614,9329.63,177783.76,90663.14,43,1,2,0,46,5.07373
76615,1194,35689.27,18886.86,11,0,0,0,11,5.82415
76616,7886.5,85775.44,72034.66,46,0,3,0,49,6.80228
76617,7390.25,86468.4,52979.65,27,0,5,1,33,6.22881
76618,94503.13,984182.49,885364.77,727,37,35,0,799,9.02453
76619,2374,73444.39,40161.79,12,0,0,0,12,2.98791
76620,3881.88,101533.28,45628.81,20,0,1,0,21,4.60236
76621,9560.88,162011.71,134599.59,69,0,5,0,74,5.49779
76622,1748,30079.86,30079.73,9,0,1,0,10,3.3245
76623,293,3581.19,3581.2,2,0,0,0,2,5.58472
76624,19119.88,138675.15,133019.07,112,0,13,0,125,9.39715
76626,2002.5,41559.59,33313.69,17,0,0,0,17,5.10301
76627,12578.38,264610.12,147009.32,90,0,3,0,93,6.32613
76628,5534.38,55173.05,55172.83,42,0,1,0,43,7.79369
76629,3075.25,49666.3,49666.41,27,0,0,0,27,5.43627
76630,1365.38,30958.22,27108.13,11,0,0,0,11,4.05782
76631,7550.75,69062.11,69062.18,68,0,1,0,69,9.991
76632,3945.63,77967.14,56030.47,15,0,5,0,20,3.56949
76634,7634.63,78803.24,70248.82,40,0,0,1,41,5.8364
76636,16281.13,150506.1,136267.32,112,14,3,0,129,9.46669
76637,3155.88,36355.96,36355.86,43,1,2,0,46,12.6527
76638,6368,87762.64,58361.02,46,0,4,0,50,8.56736
76640,44444,278030.85,211700.82,175,41,17,0,233,11.0061
76641,258.375,3410.51,3410.46,4,0,0,0,4,11.7286
76642,742.75,9037.6,9037.59,10,0,0,0,10,11.0649
76644,4435.38,37104.99,37105.15,35,3,1,0,39,10.5107
76645,1167.25,21458.08,21458.15,10,0,0,0,10,4.66023
76646,3195.63,37435.35,30631.82,23,0,1,0,24,7.83499
76647,15441.5,134086.09,125712.25,71,106,13,1,191,15.1934
76648,19528.75,157470.89,124095.89,36,17,14,0,67,5.39905
76649,5759.63,93478.38,80016.61,49,3,1,0,53,6.62362
76650,4537.13,88790.87,83539.48,27,0,0,0,27,3.232
76651,524.375,5141.86,5141.91,4,0,0,0,4,7.77921
76652,5825.63,89202.57,70994.23,47,0,1,1,49,6.90197
76653,2546.5,42132.28,42132.22,19,4,0,0,23,5.459
76654,5414.38,80359.34,80359.08,43,0,0,0,43,5.35098
76655,12736,85400.94,82924,66,209,10,0,285,34.3688
76656,4434.63,45770.53,34093.05,51,7,1,0,59,17.3056
76657,129328.63,456302.57,437787.54,72,0,16,0,88,2.01011
76658,4622.25,54435.92,54435.89,35,0,0,0,35,6.42958
76660,48459.25,177778.86,175547.41,28,12,20,1,61,3.47484
76662,939,18380.43,18380.51,6,0,0,0,6,3.26433
76663,4675.25,66808.63,45745.11,36,9,2,0,47,10.2743
76664,5022,59803.13,59803.03,8,0,7,0,15,2.50823
76665,1872.25,34457.67,27515,15,0,0,0,15,5.45157
76666,2666.25,63697.4,63697.55,14,0,4,0,18,2.82585
76667,1179,38906.27,27030.57,8,0,0,0,8,2.95961
76668,2039.63,22806.58,22806.6,13,0,0,0,13,5.70011
76669,2806.75,33792.43,33792.57,20,0,0,0,20,5.91846
76670,6905.88,65186.42,65186.49,50,0,0,0,50,7.6703
76671,625.875,6888.48,6888.49,7,0,0,0,7,10.1619
76672,3089.75,37197.18,37197.29,19,3,3,0,25,6.72092
76673,4801.13,277271.67,62340.84,44,0,0,0,44,7.05797
76674,3271.88,66334.48,55328.24,31,0,0,0,31,5.60292
76675,8225,89337.17,86344.77,65,0,2,0,67,7.75959
76676,4488.5,91182.75,62690.38,37,0,1,0,38,6.06154
76677,4326.75,69995.26,59256.78,29,4,0,0,33,5.56898
76678,9362,215359.51,125111.19,64,2,3,0,69,5.51509
76679,1352.5,34026.47,30315.59,6,0,0,0,6,1.97918
76680,995.125,25223.09,18227.07,8,0,1,0,9,4.93771
76681,52205,267817.05,202555.53,133,569,37,6,745,36.78
76682,5921.5,50346.94,48994.71,49,0,0,0,49,10.0011
76683,3248.88,52381.47,42161.49,21,0,3,0,24,5.6924
76684,9184,58074.42,58074.49,42,8,2,0,52,8.95402
76685,4836,59389.27,59389.1,45,0,2,0,47,7.91391
76686,6392.25,60316.2,60316.21,44,5,3,0,52,8.62123
76688,5454.25,85183.27,85183.18,31,3,2,1,37,4.34358
76689,8941.5,104638.37,91372.26,11,0,6,2,19,2.07941
76690,4114.5,49955.65,49955.6,36,0,0,0,36,7.2064
76691,2927.63,52410.84,49940.98,20,0,1,0,21,4.20496
76692,1442.13,47726.1,18363.27,12,3,0,0,15,8.16848
76693,8396.5,89183.18,89183.32,33,0,3,0,36,4.03663
76694,1260.38,18492.13,18492.28,11,0,0,0,11,5.94843
76695,3357,42931.64,29755.75,19,0,3,0,22,7.39353
76697,3861.5,39321.71,39321.58,35,0,1,0,36,9.15528
76698,2711.13,27887.72,27887.77,18,0,1,0,19,6.81302
76699,5022.63,100444.75,71627.98,41,0,0,0,41,5.72402
76700,12581.13,146402.04,146402.12,98,28,11,0,137,9.35779
76702,4515,151852.32,61848.78,37,0,1,0,38,6.14402
76703,501,18469.41,7094.24,5,0,0,0,5,7.04797
76705,45857,211979.94,188700.97,125,16,19,1,161,8.53202
76706,1979.63,28930.52,20777.87,20,2,0,0,22,10.5882
76707,7457.13,65137.18,65137.04,59,0,1,0,60,9.21135
76708,6360.5,73930.21,63187.61,36,0,3,0,39,6.1721
76709,24368.38,126453.85,119837.78,53,129,16,0,198,16.5223
76710,333,5562.75,5562.74,2,0,0,0,2,3.59535
76711,19394.25,121492.59,98070.69,76,169,29,0,274,27.939
76712,6290.38,56345.89,56345.91,57,0,0,0,57,10.1161
76714,4047.63,51998.39,47645.51,26,0,0,0,26,5.45697
76715,9165.63,101488.23,97683.52,33,0,6,0,39,3.99249
76716,4746.88,91860.54,49688.28,43,3,0,1,47,9.45897
76717,176,5298.16,3622.01,1,0,1,0,2,5.52179
76718,16850.88,224040.66,161952.81,81,13,15,0,109,6.73036
76719,2185.38,44715.76,32465.45,12,12,3,0,27,8.31653
76720,9092.5,288587.93,166534.4,60,2,3,0,65,3.9031
76721,2873,75541.41,49094.35,15,0,1,0,16,3.25903
76723,3094,51282.95,49667.47,29,0,0,0,29,5.83883
76724,1266.25,23011.24,23011.15,10,0,0,0,10,4.34572
76725,4066,54481.54,54481.53,24,0,0,0,24,4.40516
76726,2840.38,62714.9,43233.17,26,0,0,0,26,6.0139
76727,8716.25,175132.73,151928.82,68,0,1,0,69,4.5416
76728,10960.38,79132.48,78501.13,23,0,15,0,38,4.84069
76729,3093,34173.35,34173.28,26,0,0,0,26,7.60828
76730,776.5,15734.11,15734.1,9,0,0,0,9,5.72006
76731,1489.25,21748.57,21748.62,14,0,0,0,14,6.43719
76732,902,13687.8,13687.95,9,0,0,0,9,6.57513
76733,744,10562.42,10562.42,6,0,0,0,6,5.68052
76734,3157.5,64631,49710.97,20,0,0,0,20,4.02326
76735,2672,42407.87,39616.49,18,4,1,0,23,5.80566
76736,1940,20113.62,18782.84,23,0,1,0,24,12.7776
76737,3328.13,54305.52,51041.87,24,0,1,0,25,4.89794
76738,18585.5,113400.55,113400.7,33,6,2,0,41,3.6155
76739,2184.13,29281.7,29281.81,14,0,1,0,15,5.12263
76740,4918.38,60878.4,60878.36,38,0,3,0,41,6.73474
76741,2025.38,44312.63,43773.7,12,0,1,0,13,2.96982
76743,8874.5,106524.63,79155.33,68,0,2,1,71,8.96971
76744,1687.63,24781.75,24781.75,13,0,0,0,13,5.2458
76745,2512.63,24302.49,24302.5,18,0,1,0,19,7.81812
76746,253.375,6789.31,6789.31,3,0,0,0,3,4.41871
76747,3964.5,66111.27,38303.89,24,0,0,0,24,6.26568
76748,2692.63,43245.45,43245.36,22,0,2,0,24,5.54973
76749,1145.5,15023.83,15023.9,8,0,1,0,9,5.99045
76750,4105.13,53780.55,41226.52,14,8,9,0,31,7.51943
76751,5822.63,70067.83,70067.94,34,4,4,0,42,5.99418
76752,23155.88,248256.17,204863.76,102,15,25,1,143,6.98025
76753,7796,55240.33,53368.46,70,4,0,0,74,13.8659
76754,578.125,6576.68,6576.75,5,23,2,0,30,45.6153
76755,4184.13,72535.16,62088,33,0,1,0,34,5.4761
76756,1709.25,16464.1,16464.05,8,0,0,0,8,4.85907
76757,2921.25,50280.42,42792.5,24,0,1,0,25,5.84214
76758,95480.75,492235.9,487103.32,445,627,44,0,1116,22.911
76759,2786.5,43487.87,43488.01,21,0,1,0,22,5.05887
