"insee_2017","bati","parc","cons","mais","app","pro","div","loc","dens"
"Norm",25498819,302911633,221722300,122982,58180,16086,560,197808,8.9214300899
"14",6188694,79686004,52833290,29793,15762,5011,110,50676,9.5916798772
"27",4607760,58780968,46181546,26270,8489,2644,73,37476,8.1149296793
"50",5122465,59327955,47243391,26476,4939,2547,113,34075,7.2126490239
"61",2344658,38459127,22443625,10122,2147,1710,82,14061,6.2650306261
"76",7235242,66657581,53020448,30321,26843,4174,182,61520,11.6030706198
"14001",13529,231634,149189,88,8,7,0,103,6.90401
"14002",1046,33184,19011,7,0,0,0,7,3.68215
"14003",1989,27863,21084,16,0,2,0,18,8.53741
"14005",13341,297001,150828,89,2,4,0,95,6.29855
"14006",7360,85241,76098,61,0,0,0,61,8.01602
"14007",1073,24677,16501,6,0,0,0,6,3.63622
"14009",12316,102865,85737,95,8,2,0,105,12.2467
"14011",14732,299271,199826,83,0,4,0,87,4.3538
"14012",1485,100231,28233,8,8,0,0,16,5.66718
"14013",162,10907,3878,1,0,0,0,1,2.57849
"14014",3895,35454,29872,29,5,3,0,37,12.3863
"14015",5060,42079,42102,27,4,2,0,33,7.83811
"14016",9070,227847,91734,28,1,9,0,38,4.14242
"14019",2582,45165,45190,14,0,0,0,14,3.09806
"14020",39115,304589,248558,208,17,38,0,263,10.581
"14021",2321,16513,16524,17,2,3,1,23,13.9188
"14022",6844,49839,49874,48,4,7,0,59,11.8299
"14023",1017,15507,15518,8,0,0,0,8,5.15528
"14024",11912,157876,149872,69,103,1,0,173,11.5432
"14025",2230,29359,22360,8,0,1,0,9,4.02496
"14026",10012,108683,99925,82,0,0,0,82,8.20611
"14027",48031,562478,449443,347,64,12,2,425,9.45614
"14030",9169,57508,57537,76,14,0,0,90,15.6422
"14032",5354,253946,89271,17,0,8,0,25,2.80045
"14033",4384,275451,98872,25,0,3,0,28,2.83195
"14034",2267,45821,32248,15,0,1,0,16,4.96152
"14035",15580,163124,145526,118,6,5,0,129,8.86441
"14036",2847,33168,33182,24,0,0,0,24,7.23275
"14037",4460,78146,57167,29,0,0,0,29,5.07285
"14038",10525,88891,76507,85,0,1,0,86,11.2408
"14039",9544,101904,97007,87,0,0,0,87,8.96843
"14040",2937,39766,39790,8,6,2,0,16,4.02109
"14041",1430,131245,40523,8,0,0,0,8,1.97418
"14042",5512,51838,49049,40,0,2,0,42,8.56284
"14044",11628,92496,90607,95,3,0,0,98,10.816
"14045",1910,199286,29445,9,0,0,0,9,3.05658
"14046",13131,220424,118734,66,0,3,0,69,5.81131
"14047",102245,486414,465453,306,634,111,4,1055,22.6661
"14049",737,19239,11723,6,0,0,0,6,5.11815
"14050",1116,24357,24367,11,0,0,0,11,4.51435
"14053",684,20222,12469,4,0,0,0,4,3.20798
"14054",2177,48525,43426,14,0,0,0,14,3.22389
"14055",2341,463838,56740,10,0,0,0,10,1.76241
"14057",10726,105311,64830,99,2,4,0,105,16.1963
"14059",2922,28187,21716,17,20,1,0,38,17.4986
"14060",23407,125198,125267,154,46,10,0,210,16.7642
"14061",83616,2621946,1355879,508,14,46,2,570,4.20392
"14062",4939,35730,35752,45,0,1,0,46,12.8665
"14063",373,8820,8825,3,0,0,0,3,3.39937
"14064",2353,32396,20454,16,0,0,0,16,7.82227
"14066",17334,155228,132907,169,2,2,0,173,13.0166
"14068",55893,322237,313677,247,3,28,0,278,8.86262
"14069",14036,151019,140843,123,0,4,0,127,9.01711
"14070",2838,110762,50161,13,0,3,0,16,3.18972
"14076",60911,678425,554635,189,374,25,3,591,10.6557
"14077",6526,286211,125181,48,4,7,0,59,4.71319
"14078",5331,80527,73713,45,0,0,0,45,6.10477
"14079",18764,268209,134323,93,205,8,0,306,22.7809
"14080",669,23262,23263,3,0,0,0,3,1.28962
"14082",3748,53482,51225,30,0,2,0,32,6.24694
"14083",5066,170449,92078,20,2,3,0,25,2.71509
"14084",2781,40694,37974,22,0,0,0,22,5.79338
"14085",8177,425927,191892,50,1,4,0,55,2.8662
"14086",5543,212787,80572,26,0,2,0,28,3.47517
"14087",929,26426,23354,5,0,1,0,6,2.5692
"14088",2698,32873,32876,21,0,1,0,22,6.69175
"14089",1448,15451,15457,11,0,0,0,11,7.11663
"14090",6096,187974,50174,57,7,1,0,65,12.9548
"14091",396,15028,15037,2,0,0,0,2,1.33008
"14092",35008,232518,206560,152,57,44,0,253,12.2482
"14093",3674,143445,48822,86,0,0,0,86,17.6149
"14096",1593,44650,26435,10,0,0,0,10,3.78286
"14097",3033,25522,25527,25,0,0,0,25,9.79355
"14098",59500,476988,406253,353,33,46,0,432,10.6338
"14100",16739,169965,146605,114,4,17,2,137,9.34486
"14101",48780,170806,170882,40,194,47,1,282,16.5026
"14102",13127,217300,155991,64,2,7,1,74,4.74385
"14103",5038,54628,49842,43,0,1,0,44,8.82797
"14104",1974,157784,58370,15,0,1,0,16,2.74116
"14106",4052,46356,31193,20,0,2,0,22,7.05285
"14107",1553,22873,22887,12,0,0,0,12,5.24314
"14110",667,16495,16504,5,0,0,0,5,3.02954
"14111",2373,31870,31885,21,0,0,0,21,6.58618
"14116",1456,15814,15818,6,0,2,0,8,5.05767
"14117",39650,376856,294832,130,350,102,2,584,19.8079
"14118",235024,869906,735740,225,3064,628,14,3931,53.4292
"14119",48294,375758,277096,85,28,13,1,127,4.58326
"14120",16044,424009,266198,99,1,9,0,109,4.0947
"14121",3250,78998,79032,21,0,1,0,22,2.7837
"14122",1888,70305,29959,16,0,0,0,16,5.34064
"14123",23535,150296,150376,180,2,2,0,184,12.236
"14124",10437,150855,103194,33,4,2,0,39,3.7793
"14125",11204,68628,62473,70,6,2,0,78,12.4854
"14126",9267,289582,160991,50,5,7,0,62,3.85115
"14127",4406,125785,70224,31,0,0,0,31,4.41442
"14130",1842,54556,28857,12,0,0,0,12,4.15844
"14131",727,27760,11854,4,0,0,0,4,3.37439
"14132",2157,42184,34381,16,0,0,0,16,4.6537
"14134",1220,26676,26686,9,0,0,0,9,3.37253
"14135",3289,35621,27414,12,0,3,0,15,5.47167
"14136",18,664,665,0,0,0,0,0,0
"14137",73482,313606,310800,120,67,138,3,328,10.5534
"14138",2391,35341,29011,10,0,0,0,10,3.44696
"14140",2236,37963,37981,17,0,0,0,17,4.47593
"14141",2995,323890,58655,11,2,0,0,13,2.21635
"14143",22946,313582,283383,132,8,67,0,207,7.3046
"14145",3269,43295,43305,33,0,0,0,33,7.62037
"14146",1079,21449,21451,5,0,1,0,6,2.79705
"14147",1914,65585,47325,16,0,0,0,16,3.38085
"14149",5870,49962,49977,52,0,0,0,52,10.4047
"14150",1924,15264,15266,8,2,1,0,11,7.20538
"14159",1624,50759,26612,11,0,1,0,12,4.50924
"14160",528,5485,5486,2,0,1,0,3,5.46811
"14161",5553,382753,116945,32,0,2,0,34,2.90734
"14162",5605,117854,93902,43,0,1,0,44,4.68576
"14163",4328,81645,60336,32,0,0,0,32,5.30366
"14165",5070,726566,66337,30,0,2,1,33,4.97457
"14166",17317,103042,92764,133,23,4,0,160,17.2482
"14167",109600,731586,503601,170,499,71,0,740,14.6942
"14168",1226,23387,17282,9,0,0,0,9,5.20764
"14169",296,442,443,1,0,1,0,2,45.1772
"14171",2200,68980,30247,12,0,0,0,12,3.96729
"14172",3263,32584,31753,39,0,1,0,40,12.5971
"14173",4843,196889,74355,31,0,2,0,33,4.43817
"14174",45071,789047,508159,183,6,27,4,220,4.32936
"14175",3148,34175,34193,22,0,0,0,22,6.43409
"14177",8901,143263,100360,83,0,3,0,86,8.56913
"14179",1770,70023,49591,16,0,0,0,16,3.22638
"14180",1378,27085,22205,8,0,1,0,9,4.0532
"14181",35100,186233,186312,290,54,21,1,366,19.6445
"14182",2580,31027,27459,14,0,0,0,14,5.09845
"14183",468,8598,8598,4,0,0,0,4,4.6522
"14184",1434,20260,20272,8,0,1,0,9,4.43959
"14185",1993,111207,45820,12,0,0,0,12,2.61892
"14191",36644,286662,225437,101,267,275,0,643,28.5224
"14193",3424,124953,54764,21,0,0,0,21,3.8346
"14194",7658,243628,168900,53,0,1,0,54,3.19716
"14195",1912,38065,25573,6,0,0,0,6,2.34622
"14196",1291,16088,16099,5,0,5,0,10,6.21168
"14197",8714,63789,59247,61,0,1,0,62,10.4647
"14198",2899,83744,69725,19,0,1,0,20,2.86841
"14200",21535,155889,155983,181,4,8,0,193,12.3731
"14202",10842,88139,76991,8,0,28,0,36,4.67585
"14203",4085,151273,38422,7,0,0,0,7,1.82187
"14204",2025,29193,29215,12,0,1,0,13,4.44971
"14205",2054,20817,20827,14,0,1,0,15,7.20231
"14206",2078,32897,32897,12,0,0,0,12,3.64779
"14207",8998,113717,102922,71,0,2,0,73,7.09277
"14209",6443,118701,77314,38,0,3,0,41,5.30307
"14211",2463,86494,49324,21,0,0,0,21,4.25756
"14214",2686,77310,35407,12,3,1,0,16,4.51891
"14215",14712,92716,92760,109,0,5,0,114,12.2898
"14216",2169,19418,19419,18,0,0,0,18,9.26943
"14218",13318,174487,145624,160,50,3,0,213,14.6267
"14220",31142,150796,143442,105,514,44,2,665,46.3602
"14221",45184,228847,220686,172,80,24,0,276,12.5064
"14223",455,21463,9292,5,0,0,0,5,5.38071
"14224",303,417,418,2,0,1,0,3,71.8118
"14225",37010,305488,204729,178,306,31,1,516,25.204
"14226",2934,56674,46623,27,0,0,0,27,5.79118
"14227",2780,85641,44183,13,0,1,0,14,3.16867
"14228",62062,293184,287861,207,216,78,0,501,17.4042
"14229",11381,83109,83154,72,1,9,1,83,9.98152
"14230",1247,54203,28547,10,0,0,0,10,3.50301
"14231",5950,228347,85524,24,0,0,0,24,2.80622
"14232",1298,74334,13160,5,0,0,0,5,3.79925
"14236",7676,77750,77791,32,0,1,0,33,4.24214
"14237",7703,66195,65863,64,0,0,0,64,9.71715
"14238",1705,69136,28038,9,3,0,0,12,4.27992
"14239",192,589,589,2,0,0,0,2,33.9419
"14240",6349,127678,87466,52,0,1,0,53,6.05952
"14241",5154,138041,88781,34,1,2,0,37,4.16755
"14242",5099,28187,28201,45,0,0,0,45,15.9567
"14243",17689,232053,176772,48,82,8,1,139,7.86325
"14244",3879,93172,60425,29,0,0,0,29,4.79935
"14245",2130,37510,24140,14,0,2,0,16,6.62806
"14246",8629,72772,72808,74,0,0,0,74,10.1637
"14248",1929,18555,18559,10,0,1,0,11,5.9271
"14249",14387,116404,107078,131,11,3,0,145,13.5415
"14250",2769,77087,52830,14,0,0,0,14,2.65003
"14251",7039,113131,96030,54,0,1,0,55,5.72735
"14252",1958,59378,25935,13,0,0,0,13,5.01258
"14254",20845,125396,125445,169,28,11,0,208,16.5809
"14256",3531,40034,40061,32,0,0,0,32,7.98781
"14257",29887,183407,183467,167,19,112,1,299,16.2972
"14258",98882,485498,473381,276,335,62,1,674,14.238
"14260",3057,148743,81559,21,0,0,0,21,2.57483
"14261",6749,290618,166669,40,0,2,0,42,2.51996
"14266",12999,78092,78119,96,7,2,0,105,13.441
"14269",1649,68701,43060,8,0,0,0,8,1.85786
"14270",3163,65401,56674,19,0,1,0,20,3.52898
"14271",64056,300550,280129,107,258,55,2,422,15.0645
"14272",248,2818,2820,2,0,0,0,2,7.09329
"14273",788,73776,26952,5,0,1,0,6,2.22615
"14274",20650,130918,125237,132,30,5,0,167,13.3347
"14275",2021,12463,12470,22,0,0,0,22,17.6423
"14276",2792,38027,34424,24,0,0,0,24,6.97187
"14277",13690,90131,88236,128,12,1,0,141,15.9798
"14278",13958,120744,114459,101,0,4,0,105,9.17357
"14280",3238,260129,76709,21,0,1,0,22,2.86796
"14281",8702,182294,138168,46,0,4,0,50,3.61877
"14282",1630,32949,32962,8,0,1,0,9,2.73043
"14283",2588,90010,25851,20,0,0,0,20,7.73669
"14284",3008,31647,28579,4,0,0,0,4,1.39962
"14285",870,18226,18235,5,0,0,0,5,2.74205
"14286",6250,255651,175981,42,0,0,0,42,2.38663
"14287",20911,137894,137947,184,0,6,0,190,13.7734
"14288",5283,73434,59522,32,0,1,0,33,5.54415
"14289",6660,104512,95064,54,0,1,0,55,5.78556
"14290",8067,72853,65582,70,0,0,0,70,10.6737
"14291",2590,27121,27126,19,0,1,0,20,7.3729
"14293",3377,196449,85955,19,0,2,0,21,2.44314
"14294",8449,67002,67024,66,0,4,0,70,10.444
"14297",10528,75939,73625,101,0,0,0,101,13.7183
"14298",1460,33703,20507,8,0,2,0,10,4.87634
"14299",9215,341629,134065,62,2,1,0,65,4.8484
"14300",1812,87444,14076,3,0,0,0,3,2.13122
"14301",39159,238299,218850,299,5,19,0,323,14.759
"14302",1805,146237,26946,9,0,0,0,9,3.34004
"14303",21947,310758,160854,48,0,6,0,54,3.35708
"14304",15273,296707,188007,73,106,4,0,183,9.73369
"14305",13142,368543,199932,65,0,2,0,67,3.35114
"14306",4738,44063,44088,29,0,1,0,30,6.80454
"14307",1306,11850,11853,10,0,0,0,10,8.43703
"14308",1536,19669,19679,9,0,0,0,9,4.57336
"14309",2916,36987,24063,23,0,3,0,26,10.8051
"14310",6739,70158,57376,60,0,0,0,60,10.4573
"14311",4861,47889,41762,29,4,0,0,33,7.90184
"14312",20222,181829,156644,157,152,9,1,319,20.3647
"14316",4532,120815,94380,25,0,1,0,26,2.75483
"14318",8902,75592,75644,12,0,2,1,15,1.98297
"14319",34073,184693,156710,83,0,27,0,110,7.01934
"14320",807,11001,11004,5,0,0,0,5,4.54385
"14322",3799,98333,62336,21,0,0,0,21,3.36884
"14325",25995,139607,136988,245,64,9,0,318,23.2138
"14326",24392,341231,252248,52,0,17,0,69,2.73541
"14327",129055,568573,467127,95,1135,212,1,1443,30.891
"14328",8655,60392,59912,45,16,1,0,62,10.3486
"14329",1115,40073,27336,10,0,0,0,10,3.65814
"14332",6258,132651,75325,49,0,2,0,51,6.77063
"14333",145338,953292,683357,371,474,114,3,962,14.0776
"14334",3366,83183,64634,26,0,0,0,26,4.02265
"14335",5160,289821,95828,13,0,1,0,14,1.46095
"14336",4216,57139,48702,22,0,2,0,24,4.92793
"14337",4952,89176,57145,23,0,0,0,23,4.02487
"14338",36452,332491,326666,355,274,17,2,648,19.8368
"14339",2571,16191,16197,25,0,0,0,25,15.4349
"14341",152871,756143,731892,412,241,97,3,753,10.2884
"14342",30248,415247,275983,92,47,19,2,160,5.79746
"14343",1152,74880,48552,2,0,1,0,3,0.617889
"14344",784,39082,17838,4,0,1,0,5,2.80306
"14345",2039,25949,25952,8,0,0,0,8,3.08259
"14346",4190,180603,57631,29,0,1,0,30,5.20557
"14347",10490,225981,174314,66,0,3,1,70,4.01574
"14348",855,19149,19156,5,0,2,0,7,3.65412
"14349",21482,165584,152569,203,4,4,0,211,13.8298
"14352",7276,184698,126381,44,0,0,0,44,3.48154
"14353",4665,62634,48229,34,0,0,0,34,7.04964
"14354",9427,79485,79538,62,16,3,1,82,10.3096
"14355",5958,84000,68705,48,0,0,0,48,6.98641
"14357",4659,192156,98968,25,0,2,0,27,2.72817
"14358",1023,58360,22448,6,0,0,0,6,2.67287
"14360",2716,57113,35697,20,0,0,0,20,5.6027
"14362",773,228551,22408,6,0,1,0,7,3.12383
"14364",2293,32051,32065,9,0,0,0,9,2.80677
"14365",9971,58805,52450,81,64,9,0,154,29.3612
"14366",166603,891547,715909,294,762,222,10,1288,17.9911
"14367",2716,102616,52564,21,0,0,0,21,3.99511
"14368",2320,97895,67261,16,0,3,0,19,2.82481
"14369",3882,40469,40486,20,0,4,0,24,5.92803
"14370",24877,278106,220793,160,23,15,1,199,9.01296
"14371",58672,2159773,961981,271,15,33,1,320,3.32647
"14374",729,23922,13283,5,0,0,0,5,3.76434
"14375",1004,18232,18231,10,0,0,0,10,5.48521
"14377",4583,61632,54006,29,0,2,0,31,5.74014
"14378",3518,51382,41681,21,0,1,0,22,5.2782
"14379",2385,45629,44662,15,0,0,0,15,3.35858
"14380",1588,41302,27146,11,0,1,0,12,4.42061
"14381",272,1007,1007,3,0,0,0,3,29.793
"14383",38727,267792,166857,152,217,46,0,415,24.8717
"14384",24626,162159,125826,125,46,117,0,288,22.8887
"14385",1445,13561,13569,9,0,0,0,9,6.63262
"14389",1820,110451,69603,8,0,8,0,16,2.29877
"14390",696,12069,12072,6,0,0,0,6,4.97015
"14391",3524,51092,46273,25,0,3,0,28,6.05106
"14393",3101,47586,35220,22,0,1,0,23,6.53033
"14394",2690,41782,24544,16,0,0,1,17,6.92621
"14396",15183,104652,104691,131,5,0,0,136,12.9907
"14397",3613,61675,52886,29,0,0,0,29,5.48352
"14398",6560,345882,136967,33,0,0,0,33,2.40933
"14399",1562,65694,42953,10,0,0,0,10,2.32814
"14400",1728,28079,28096,14,0,0,0,14,4.98285
"14401",1220,13178,13187,9,0,0,0,9,6.82468
"14402",931,12128,12128,8,0,0,0,8,6.59641
"14403",26409,335782,188949,47,9,10,0,66,3.49301
"14404",551,13838,5438,5,0,0,0,5,9.19521
"14405",2237,57902,46007,14,0,0,0,14,3.04302
"14406",11549,120096,120163,84,0,1,0,85,7.0737
"14407",21739,190556,153364,149,61,2,0,212,13.8234
"14408",14771,169957,107856,134,10,1,1,146,13.5366
"14409",29399,199220,178551,168,244,14,1,427,23.9147
"14410",12453,286434,139350,96,0,5,0,101,7.24796
"14411",5572,70994,56744,17,0,1,0,18,3.17214
"14412",899,13523,13526,8,0,0,0,8,5.91439
"14419",1621,87320,31366,8,0,0,0,8,2.55051
"14421",5729,150840,83835,47,0,0,0,47,5.60625
"14424",2231,50927,38903,15,0,0,0,15,3.85578
"14425",1095,58685,31987,8,0,0,0,8,2.50104
"14426",1412,44237,37812,11,0,1,0,12,3.17357
"14427",689,8524,8523,5,0,0,0,5,5.86617
"14430",1246,15969,15980,7,0,1,0,8,5.00613
"14431",70719,1410894,807360,460,93,44,0,597,7.39447
"14435",788,23455,15753,7,0,0,0,7,4.44371
"14436",9093,73704,73746,73,0,0,0,73,9.8988
"14437",118916,591110,491121,110,421,103,7,641,13.0518
"14438",2672,19322,19330,24,0,0,0,24,12.416
"14439",325,15456,10223,4,0,0,0,4,3.9126
"14445",1314,32127,25286,7,0,1,0,8,3.16381
"14446",318,3592,3593,2,0,0,0,2,5.56642
"14449",3033,49975,46992,16,0,1,0,17,3.61763
"14452",5174,55771,56148,33,0,1,0,34,6.0554
"14453",4663,152390,61697,36,0,0,0,36,5.83495
"14454",24797,150048,144653,65,0,31,0,96,6.63656
"14455",2189,24803,24806,17,0,0,0,17,6.85308
"14456",51162,432580,394187,293,16,32,0,341,8.65072
"14457",129,679,679,2,0,0,0,2,29.4624
"14458",2257,86735,47959,15,0,1,0,16,3.33621
"14460",15155,310313,231692,99,1,5,0,105,4.53187
"14461",3242,135147,34463,21,0,1,0,22,6.38373
"14465",12336,116168,116231,41,0,16,0,57,4.90401
"14466",2645,124667,42296,21,0,1,0,22,5.20144
"14467",3812,80052,50859,32,0,0,0,32,6.29196
"14468",4370,83050,46241,34,0,2,0,36,7.78532
"14469",145,2890,2890,1,0,0,0,1,3.45996
"14473",1120,44841,6643,1,0,1,0,2,3.01078
"14474",815,14369,14374,5,0,0,0,5,3.47844
"14475",13612,153394,143192,101,8,3,0,112,7.82164
"14476",938,7975,7976,7,0,0,0,7,8.77667
"14478",10411,88525,85795,22,22,15,0,59,6.87689
"14480",3388,34695,34718,28,0,1,0,29,8.35291
"14482",1466,24967,20342,11,0,0,0,11,5.40759
"14483",1245,24458,18273,9,0,0,0,9,4.92532
"14484",3571,118217,87346,23,0,0,0,23,2.63321
"14486",3988,67135,52265,29,0,2,0,31,5.93126
"14487",5239,113031,52272,49,0,0,0,49,9.37402
"14488",64862,306566,306748,409,209,70,0,688,22.4288
"14491",2225,27427,27436,14,0,0,0,14,5.10287
"14492",3821,130525,84430,20,0,2,0,22,2.6057
"14494",6750,127532,42929,5,0,4,0,9,2.09648
"14495",5409,49507,49536,37,1,0,0,38,7.67126
"14496",161,2222,2222,1,0,0,0,1,4.50015
"14497",2316,28456,28459,22,0,0,0,22,7.73032
"14498",1185,21273,18415,8,0,0,0,8,4.34437
"14499",6611,51828,51856,45,0,1,0,46,8.87074
"14500",3075,133422,67012,19,0,1,0,20,2.98455
"14501",850,85727,23303,7,0,0,0,7,3.00395
"14502",732,16449,16449,5,0,1,0,6,3.64756
"14504",13099,362084,285637,81,1,0,0,82,2.87077
"14505",1904,56818,37395,12,0,0,0,12,3.20896
"14506",2003,25497,18520,12,0,1,0,13,7.01945
"14509",409,20044,10117,3,0,0,0,3,2.96532
"14510",119,2106,2106,1,0,0,0,1,4.74909
"14511",620,27535,10243,3,0,0,0,3,2.92887
"14512",39,41,41,0,0,0,0,0,0
"14513",4683,122376,64014,21,28,2,0,51,7.967
"14514",52596,342137,308847,252,179,50,0,481,15.5741
"14515",23545,191710,191844,255,132,9,3,399,20.7981
"14516",21098,216716,125023,115,1,4,0,120,9.5982
"14519",312,4091,4092,3,0,0,0,3,7.33125
"14520",6825,210304,131234,50,0,4,0,54,4.11478
"14522",3660,154245,84017,26,0,2,0,28,3.33264
"14524",439,29336,13903,4,0,0,0,4,2.87712
"14527",2139,105688,54014,17,0,1,0,18,3.33247
"14528",4418,257034,117788,28,2,0,0,30,2.54694
"14529",2200,45037,29117,17,0,1,0,18,6.18197
"14530",11162,75606,73343,69,13,9,0,91,12.4074
"14533",896,16629,16637,6,0,0,0,6,3.60639
"14534",5620,136844,89721,36,7,1,0,44,4.90409
"14535",3030,46308,28135,25,1,1,0,27,9.59652
"14536",34149,345930,297145,233,285,10,0,528,17.7691
"14538",7681,54975,54992,65,9,0,0,74,13.4564
"14540",5340,160003,74145,11,0,2,0,13,1.75332
"14541",2193,79855,38029,11,0,0,0,11,2.89251
"14542",5906,50734,50760,40,4,1,0,45,8.86528
"14543",38701,303793,272052,112,29,25,0,166,6.10177
"14546",772,10449,10451,6,0,0,0,6,5.74131
"14547",1811,34608,34630,14,0,0,0,14,4.04278
"14550",454,45633,11659,6,0,0,0,6,5.14625
"14552",4493,43629,43658,27,2,0,0,29,6.64261
"14554",7450,50039,50053,8,0,7,0,15,2.99682
"14555",4994,279149,102196,25,5,6,0,36,3.52263
"14556",15843,80703,80732,63,13,29,0,105,13.006
"14557",20912,128073,128162,59,235,20,0,314,24.5003
"14558",5012,27502,27518,15,7,6,0,28,10.1751
"14559",1174,33195,22994,7,0,0,0,7,3.04431
"14562",26409,139055,139149,170,162,5,0,337,24.2187
"14563",5802,264658,119740,34,0,3,0,37,3.09003
"14565",2612,103365,29672,14,2,1,0,17,5.72935
"14566",39398,219838,219946,187,0,117,0,304,13.8215
"14569",2885,31694,31715,22,0,0,0,22,6.93678
"14570",19020,588919,367002,141,4,5,0,150,4.08717
"14571",2134,52885,33447,10,0,3,0,13,3.88675
"14572",4821,83573,71734,35,0,2,0,37,5.15791
"14574",16949,722713,170933,78,0,8,0,86,5.0312
"14575",5079,208903,99958,22,0,3,0,25,2.50104
"14576",4619,306634,105326,32,0,1,0,33,3.13313
"14578",15916,677273,246502,73,0,36,1,110,4.46243
"14579",12307,284783,223468,75,0,7,0,82,3.66942
"14582",15054,258034,169802,37,9,1,0,47,2.76794
"14586",1719,28534,25910,13,0,0,0,13,5.01742
"14587",4105,19349,14246,22,68,1,0,91,63.8754
"14588",3455,94871,73065,24,0,0,0,24,3.28474
"14589",4675,42094,42102,46,0,1,0,47,11.1633
"14590",248,3866,3868,2,0,0,0,2,5.17115
"14591",8456,174028,113699,78,0,3,0,81,7.12408
"14592",13657,139365,123002,98,0,2,0,100,8.12993
"14593",9520,523964,236422,71,0,1,0,72,3.04541
"14595",1490,31397,20326,13,0,0,0,13,6.39579
"14598",1207,28379,27542,8,0,0,0,8,2.90463
"14601",2995,60056,50726,8,0,2,0,10,1.97137
"14602",3020,106781,39253,22,0,0,0,22,5.60461
"14603",1528,15162,15165,10,0,1,0,11,7.25346
"14604",1353,71566,31089,9,0,0,0,9,2.89496
"14605",6531,58718,57025,50,0,2,1,53,9.29416
"14606",1128,68715,28128,6,0,0,0,6,2.13308
"14607",704,24258,8937,4,0,1,0,5,5.59457
"14609",11444,246655,98437,65,0,6,0,71,7.21276
"14610",21382,209058,195859,161,3,5,0,169,8.62866
"14613",304,26452,10866,2,0,0,0,2,1.84058
"14614",8755,115128,105771,30,0,4,0,34,3.21448
"14619",2204,96463,45653,10,0,1,0,11,2.40947
"14620",4833,188466,75065,32,0,0,0,32,4.263
"14621",6851,192221,114710,36,1,1,0,38,3.31271
"14622",1317,50340,30882,5,0,0,0,5,1.61908
"14623",30238,181221,181284,263,0,2,0,265,14.618
"14625",3890,230601,59684,14,4,2,0,20,3.35097
"14626",5549,178402,94358,45,0,1,0,46,4.87505
"14627",2852,49358,42767,14,0,1,0,15,3.50738
"14630",17483,133426,129647,70,0,11,0,81,6.24773
"14635",1517,21699,21700,11,0,1,0,12,5.53002
"14637",2997,41762,33844,20,0,0,0,20,5.90942
"14639",2858,55963,30932,6,0,0,0,6,1.93971
"14640",2931,105714,40633,15,0,2,0,17,4.18381
"14643",10047,207629,154123,63,0,4,0,67,4.34718
"14644",4049,121843,98106,29,0,1,0,30,3.05793
"14645",2745,129413,59716,16,0,0,0,16,2.67935
"14646",3317,42598,33453,30,0,0,0,30,8.96785
"14648",3219,137202,75348,24,0,1,0,25,3.31794
"14649",3956,111927,46698,31,0,0,0,31,6.63835
"14650",1024,22346,16681,8,1,0,0,9,5.39549
"14651",3662,122759,46802,23,0,1,0,24,5.12794
"14652",448,2451,2453,1,0,0,0,1,4.07708
"14654",72039,1152558,706796,279,29,32,1,341,4.82459
"14656",4868,46132,46136,39,1,3,0,43,9.32034
"14657",2101,44266,31675,13,0,1,0,14,4.41984
"14658",43362,1529595,660392,208,0,9,1,218,3.30107
"14659",11968,89064,89087,117,0,1,1,119,13.3577
"14660",813,30665,14276,5,0,0,1,6,4.20273
"14661",928,22891,18031,9,0,0,0,9,4.99147
"14663",44011,340832,229908,259,71,30,2,362,15.7455
"14664",1518,28007,28017,11,0,0,0,11,3.92618
"14665",2837,60899,29694,23,0,1,0,24,8.08241
"14667",2838,77887,55271,13,0,0,0,13,2.35206
"14668",5327,92959,78708,43,0,0,0,43,5.46322
"14669",1701,50065,19615,10,0,1,0,11,5.6079
"14672",8483,150889,134636,54,0,3,0,57,4.23364
"14674",1452,16195,16198,14,0,0,0,14,8.64284
"14675",15382,80047,77047,63,4,15,0,82,10.6428
"14676",7809,64443,64483,69,0,1,0,70,10.8555
"14677",1171,32637,19322,8,0,0,0,8,4.14033
"14678",4315,44229,38102,15,0,4,0,19,4.9866
"14679",7803,67303,67340,58,0,3,0,61,9.05849
"14680",5252,153821,64056,11,1,3,0,15,2.34171
"14681",1251,26976,19810,10,0,0,0,10,5.04795
"14682",5913,199801,113857,32,0,1,0,33,2.89838
"14684",1118,55264,16869,10,0,0,0,10,5.92818
"14685",6464,51182,43882,50,0,0,0,50,11.3942
"14687",1913,44813,34600,12,0,0,0,12,3.4682
"14689",32585,668809,444601,202,11,15,0,228,5.1282
"14691",2374,15512,15517,19,0,0,0,19,12.2445
"14692",18760,144322,131060,144,22,6,0,172,13.1237
"14694",5339,169462,132344,38,0,0,0,38,2.8713
"14698",5980,69671,63006,26,0,3,0,29,4.60275
"14699",36621,359881,223529,158,535,22,0,715,31.9868
"14700",7787,212292,147733,49,0,5,0,54,3.65524
"14701",10560,479352,151457,30,28,3,0,61,4.02755
"14703",3192,214285,60800,26,0,0,0,26,4.27634
"14705",981,10078,7687,3,0,0,0,3,3.9026
"14706",1669,136140,31259,14,0,0,0,14,4.47873
"14707",8400,56665,36385,17,1,2,0,20,5.49683
"14708",936,9284,9287,7,0,0,0,7,7.53766
"14709",3855,67693,46078,30,0,1,0,31,6.72778
"14710",652,9519,9519,6,0,0,0,6,6.30322
"14711",6432,111566,51989,45,0,3,0,48,9.2327
"14712",40124,348168,264061,235,61,33,0,329,12.4593
"14713",2888,73120,62464,23,0,0,0,23,3.68215
"14714",3986,74698,64875,27,0,2,0,29,4.47016
"14715",41691,249963,229885,172,362,37,0,571,24.8385
"14716",986,21362,21372,8,0,0,0,8,3.74325
"14719",6682,70668,61148,61,0,1,0,62,10.1394
"14720",5653,87885,52173,40,0,1,0,41,7.85852
"14721",5100,78841,64935,43,0,2,0,45,6.92996
"14723",1631,120391,40421,13,0,1,0,14,3.46357
"14724",14003,182027,99919,111,0,2,1,114,11.4092
"14726",51005,1253616,831923,331,3,14,2,350,4.20712
"14728",7801,113098,52357,48,0,4,0,52,9.93175
"14731",2786,86739,57929,15,1,1,0,17,2.93462
"14732",5366,147349,55847,13,1,1,0,15,2.68591
"14733",1398,25601,17730,6,0,0,0,6,3.38402
"14734",2585,32525,32538,19,0,0,0,19,5.83942
"14735",3328,68284,44296,25,0,2,0,27,6.09539
"14737",3488,45404,41265,25,0,2,0,27,6.54308
"14738",41632,230961,207458,69,64,71,0,204,9.83332
"14739",12448,78306,78360,110,16,0,0,126,16.0795
"14740",15796,284509,182367,76,1,11,0,88,4.82542
"14741",1636,26993,21718,12,0,0,0,12,5.52545
"14742",192,3505,3505,2,0,0,0,2,5.70612
"14743",1578,27005,27016,1,0,0,0,1,0.37015
"14744",3703,52256,52287,27,0,0,0,27,5.1638
"14745",4328,56784,56827,31,0,1,0,32,5.63114
"14747",6421,47782,47798,51,7,0,0,58,12.1343
"14748",1146,66553,27438,10,0,0,0,10,3.6446
"14751",2731,44587,32744,17,0,2,0,19,5.80257
"14752",39898,250325,250398,151,55,28,0,234,9.34513
"14753",7661,93978,76779,67,0,1,0,68,8.85661
"14754",31266,526663,249572,224,90,11,1,326,13.0624
"14755",1628,34695,21742,10,7,1,0,18,8.27895
"14756",1859,58293,40663,15,0,0,0,15,3.68889
"14758",6402,51040,51068,43,0,0,0,43,8.42017
"14759",2488,30103,30104,22,0,0,0,22,7.30805
"14760",7058,114373,114411,54,0,1,0,55,4.80724
"14761",8631,58383,54714,80,0,1,0,81,14.8042
"14762",187019,2172039,1526396,588,193,257,7,1045,6.84619
"14764",3754,47881,47880,20,17,2,0,39,8.14542
"27001",1577,31915,31710,15,0,1,0,16,5.04568
"27002",1477,27108,23725,17,0,1,0,18,7.58709
"27003",5941,86979,55435,35,0,3,1,39,7.03525
"27004",3601,41637,41637,32,0,0,0,32,7.68539
"27005",7181,109426,108724,73,0,1,0,74,6.80621
"27006",1186,33124,32205,10,0,0,0,10,3.10506
"27008",16805,162296,162296,67,39,19,0,125,7.70198
"27009",3169,61086,52769,46,0,0,0,46,8.71719
"27010",837,13676,13588,9,0,1,0,10,7.35927
"27011",5927,69734,67991,50,0,0,0,50,7.35393
"27012",2320,30547,30351,19,0,0,0,19,6.26007
"27013",2344,42884,36046,18,0,1,0,19,5.27111
"27014",2957,37083,35382,23,1,0,0,24,6.78317
"27015",10110,103403,103403,79,0,2,1,82,7.93013
"27016",31189,272776,246777,201,262,33,2,498,20.1801
"27017",8041,41938,41938,28,0,8,0,36,8.58408
"27018",6564,116744,111236,70,0,1,0,71,6.38284
"27019",1510,57666,25121,8,0,1,0,9,3.58264
"27020",4046,175581,36266,29,0,3,0,32,8.82377
"27021",3534,124060,97200,35,0,1,0,36,3.70372
"27022",54677,337010,332892,315,79,21,2,417,12.5266
"27023",6434,52887,52887,54,0,0,0,54,10.2104
"27025",4283,48341,48031,44,0,0,0,44,9.16075
"27026",1411,41355,25205,14,0,2,0,16,6.34786
"27027",6130,46138,45357,27,0,4,0,31,6.83463
"27028",1369,31480,25512,18,0,0,0,18,7.05541
"27031",4925,40012,40012,37,0,0,0,37,9.24717
"27032",9777,121569,115309,87,0,2,0,89,7.71842
"27033",1281,13692,13692,10,0,0,0,10,7.30357
"27034",3378,61910,53393,36,0,0,0,36,6.74242
"27035",552,15374,9542,6,0,1,0,7,7.33569
"27036",5197,70759,65832,43,3,1,0,47,7.13937
"27037",15154,186782,186782,110,0,1,0,111,5.94277
"27038",8933,125302,93467,31,0,61,0,92,9.84308
"27039",3958,79815,76553,29,0,0,0,29,3.78822
"27040",4194,87802,87239,47,0,1,0,48,5.50213
"27042",74,2977,2958,1,0,0,0,1,3.38077
"27043",4819,109668,88195,33,0,1,0,34,3.85508
"27044",2225,21239,21239,18,0,0,0,18,8.47509
"27045",4672,69067,68624,51,0,0,0,51,7.4318
"27046",1156,30152,23273,12,0,1,0,13,5.58594
"27047",2543,48702,48390,36,0,1,0,37,7.64625
"27048",1270,38415,20314,10,0,1,0,11,5.41501
"27049",37563,1275487,828996,345,0,18,0,363,4.37879
"27050",1852,47021,42114,18,0,0,0,18,4.27409
"27051",13325,171174,170076,144,32,11,0,187,10.9951
"27052",2457,72393,46866,19,0,0,0,19,4.05407
"27053",1609,11132,11132,6,0,3,0,9,8.08492
"27054",4595,145447,73347,48,0,0,0,48,6.54424
"27055",2341,38772,31395,23,0,0,0,23,7.32603
"27056",89322,889841,543805,255,218,91,1,565,10.3898
"27057",2279,97770,27938,15,0,1,0,16,5.72694
"27059",208,2822,2804,3,0,0,0,3,10.6994
"27061",1965,75575,41507,23,0,0,0,23,5.54125
"27062",16412,325109,243631,115,6,4,0,125,5.13071
"27063",1501,27094,26920,16,0,0,0,16,5.94346
"27064",8507,136749,131771,72,2,1,0,75,5.69168
"27065",57274,698586,528115,325,427,23,0,775,14.6748
"27066",3175,56327,55966,34,0,0,0,34,6.07514
"27067",9342,98750,98117,94,29,0,0,123,12.5361
"27068",1077,16794,16686,12,0,0,0,12,7.19151
"27069",6949,101850,90784,36,0,2,0,38,4.18576
"27070",2327,38173,37928,24,0,0,1,25,6.5914
"27071",1795,56651,42642,19,0,1,0,20,4.69024
"27072",3477,51349,51020,31,2,1,0,34,6.66409
"27073",6479,89745,89169,69,0,0,0,69,7.73808
"27074",2607,63224,48013,20,0,1,0,21,4.37382
"27075",1131,33885,29996,13,0,0,0,13,4.33384
"27076",2943,121373,46550,21,0,1,0,22,4.72606
"27077",6868,87085,59239,74,0,0,0,74,12.4917
"27078",931,58004,16327,4,0,0,0,4,2.44996
"27079",2720,97014,70402,30,0,1,0,31,4.40331
"27081",1617,18074,18074,11,0,0,0,11,6.08609
"27082",11368,66739,66739,58,56,12,0,126,18.8795
"27083",2348,47394,43268,20,0,0,0,20,4.62237
"27085",12078,207953,180763,96,0,1,0,97,5.36614
"27089",6220,109728,84549,49,0,0,0,49,5.79543
"27090",25096,239479,205797,144,6,8,0,158,7.67746
"27091",10377,417169,125564,51,0,4,2,57,4.53953
"27094",1791,132356,25539,15,0,0,0,15,5.87332
"27095",9670,150251,119569,76,0,2,0,78,6.52342
"27096",2229,85193,63499,25,0,0,0,25,3.93706
"27097",2785,33734,33518,23,6,1,0,30,8.9505
"27098",220,8685,8629,3,0,0,0,3,3.47654
"27099",5758,76831,76831,53,0,0,1,54,7.02842
"27100",35937,342655,273445,106,148,12,0,266,9.72774
"27101",7120,178420,138176,53,0,0,0,53,3.83568
"27102",10085,213602,149765,66,5,1,1,73,4.87432
"27103",62189,527440,475218,261,79,44,1,385,8.10154
"27104",3726,120235,47270,35,0,3,0,38,8.03894
"27105",31965,546550,327087,156,47,27,1,231,7.06235
"27106",3218,73167,65951,36,0,0,0,36,5.45857
"27107",16771,257270,214304,108,5,8,0,121,5.64618
"27108",10578,92856,85996,57,0,4,0,61,7.09339
"27109",5347,64085,64085,43,0,0,0,43,6.70981
"27110",8142,137970,118332,55,0,0,0,55,4.64793
"27111",873,12212,12134,5,0,1,0,6,4.9449
"27112",34150,600974,328078,154,93,22,0,269,8.19927
"27113",712,40325,23637,7,0,0,0,7,2.9614
"27114",4977,87218,75833,37,4,4,0,45,5.93409
"27115",2013,26438,24231,12,0,1,1,14,5.77773
"27116",22754,228232,207625,147,91,15,1,254,12.2336
"27117",16921,176680,157189,29,40,11,0,80,5.0894
"27118",4257,64626,64626,26,0,1,0,27,4.17788
"27119",10672,111029,111029,62,6,7,0,75,6.755
"27120",6707,67404,63706,45,0,1,0,46,7.22066
"27123",3739,32245,32245,32,0,2,0,34,10.5442
"27124",387,7211,7165,4,0,0,0,4,5.58289
"27125",5831,76184,71508,44,0,0,0,44,6.15315
"27126",16118,295175,225791,121,1,3,0,125,5.53609
"27127",4800,44816,44816,32,0,1,0,33,7.3635
"27129",2540,72876,53410,22,0,2,0,24,4.49353
"27130",3090,128387,76889,33,0,1,1,35,4.55203
"27132",6904,69758,69758,51,0,0,0,51,7.31102
"27133",9431,141498,134653,52,0,2,0,54,4.0103
"27134",4487,65382,54213,27,0,3,0,30,5.5337
"27135",4448,56580,56579,36,0,1,0,37,6.53947
"27136",4277,77832,77832,13,0,4,0,17,2.18419
"27137",235,4148,4121,3,0,0,0,3,7.27909
"27138",3700,127796,86603,26,0,1,0,27,3.11768
"27139",801,27324,13507,5,0,0,0,5,3.70184
"27140",990,13256,13256,9,0,0,0,9,6.78929
"27141",758,14883,14788,9,0,0,0,9,6.08621
"27142",2782,33071,32859,20,3,8,0,31,9.43427
"27143",125,2700,2683,1,0,0,0,1,3.72762
"27144",1458,25554,25390,10,0,1,0,11,4.33238
"27146",3417,113936,85232,35,0,1,0,36,4.22377
"27147",7382,91148,91148,49,0,1,0,50,5.48558
"27148",3092,132783,76846,18,0,1,0,19,2.47247
"27149",738,19248,19125,9,0,0,0,9,4.706
"27151",7940,121862,121081,62,13,14,0,89,7.35048
"27152",3351,17817,17703,7,12,2,0,21,11.8626
"27153",2789,35076,34851,22,0,2,0,24,6.88644
"27154",3617,41035,38951,28,0,0,0,28,7.18846
"27155",541,4276,4276,4,0,0,0,4,9.35561
"27156",5103,195530,100695,64,0,1,0,65,6.45514
"27157",14740,222165,208544,118,0,4,1,123,5.89803
"27158",2903,35011,35011,23,0,0,0,23,6.56931
"27161",9065,120216,115499,70,0,2,0,72,6.23383
"27162",2252,42768,28534,18,0,0,0,18,6.30818
"27163",1954,29765,25887,17,0,0,0,17,6.56701
"27164",5981,108882,93515,63,0,0,0,63,6.73685
"27165",61651,391850,391850,319,100,23,0,442,11.2798
"27167",4909,155733,121495,52,0,0,0,52,4.28002
"27168",1270,13352,13352,9,1,1,0,11,8.23843
"27169",9549,208644,154578,80,0,0,0,80,5.1754
"27170",7542,130171,88581,59,15,12,0,86,9.7086
"27171",3087,43105,43105,20,0,1,0,21,4.87185
"27173",914,25028,18371,10,0,0,0,10,5.44323
"27174",21258,261722,261387,94,0,7,0,101,3.86401
"27175",4559,220292,60666,48,0,1,0,49,8.07704
"27176",1145,14180,14089,11,0,1,0,12,8.51725
"27177",2338,30717,24328,16,0,0,0,16,6.5769
"27179",10715,123274,117714,56,0,4,0,60,5.09712
"27180",14758,194545,161453,161,15,5,0,181,11.2107
"27181",2296,53434,42932,23,0,1,0,24,5.59026
"27182",639,8682,8682,5,0,0,0,5,5.75906
"27183",9107,92778,92183,94,10,2,1,107,11.6073
"27184",171,890,890,1,0,0,0,1,11.2392
"27185",5093,64147,64147,49,0,1,0,50,7.79454
"27187",2764,41665,35924,21,0,0,0,21,5.8456
"27188",55483,287863,278710,94,10,8,1,113,4.0544
"27189",6622,89395,83681,52,0,0,1,53,6.33355
"27190",1151,21167,17986,4,0,3,0,7,3.89184
"27191",12354,190748,179699,118,17,2,0,137,7.62388
"27192",9842,84630,81055,26,0,15,0,41,5.05832
"27193",3298,33206,32993,30,3,0,0,33,10.0021
"27194",4663,53605,53261,24,0,0,1,25,4.69384
"27196",8597,74843,64140,47,32,2,0,81,12.6287
"27198",28767,521150,402966,207,38,20,0,265,6.57623
"27199",2000,17732,17618,12,19,1,0,32,18.1629
"27200",949,10895,10895,6,0,0,0,6,5.50696
"27201",2345,22658,22658,14,0,0,0,14,6.1788
"27202",2163,28734,28550,21,0,0,0,21,7.35558
"27203",5385,58113,50820,17,0,15,0,32,6.29671
"27204",2254,28369,28187,22,1,0,0,23,8.15977
"27205",1201,19853,19726,11,0,0,0,11,5.57648
"27206",2765,44274,43990,23,0,1,0,24,5.45578
"27207",5444,156109,73786,26,0,0,0,26,3.52371
"27208",310,4450,4421,3,0,1,0,4,9.04676
"27209",8269,146935,146934,63,0,1,0,64,4.35569
"27210",7273,112390,77551,31,0,3,0,34,4.38423
"27212",811,11567,11567,7,0,0,0,7,6.05164
"27213",24739,474820,353970,250,24,10,0,284,8.02327
"27214",2337,25345,25182,22,5,0,0,27,10.7218
"27215",2694,31131,31131,24,0,0,0,24,7.70929
"27216",3469,40313,40313,25,0,1,0,26,6.44951
"27217",9807,62465,62465,33,0,2,0,35,5.60315
"27218",14754,373537,259624,138,6,13,1,158,6.08572
"27219",7340,83526,83525,56,0,1,0,57,6.82428
"27220",734,9197,9138,7,0,0,0,7,7.66029
"27222",1679,40217,39959,15,0,0,0,15,3.75385
"27224",5274,81576,72018,31,0,1,0,32,4.44336
"27226",18679,185442,184253,167,23,22,0,212,11.5059
"27227",6705,130832,94177,50,0,0,0,50,5.30914
"27228",2485,30216,30216,18,0,0,0,18,5.95707
"27229",225010,1220721,1138162,553,1792,212,9,2566,22.5451
"27230",13692,94214,93610,93,118,10,1,222,23.7155
"27231",2888,18900,18900,9,0,1,0,10,5.29113
"27232",1760,21433,21296,19,0,0,0,19,8.92206
"27233",11321,303526,163939,88,0,1,0,89,5.42885
"27234",2141,19552,19552,20,1,0,0,21,10.7406
"27235",446,9116,9058,5,0,0,0,5,5.52025
"27237",1428,56810,24154,10,0,1,0,11,4.55411
"27238",13062,128452,128452,77,1,4,1,83,6.46157
"27239",2184,79621,53724,22,0,1,0,23,4.28112
"27240",409,3174,3154,3,0,1,0,4,12.6838
"27241",1416,26106,26106,13,0,0,0,13,4.97973
"27242",7478,130595,113187,50,0,4,0,54,4.77086
"27243",5023,120325,81847,35,3,0,0,38,4.64281
"27245",1358,34107,30780,15,0,1,0,16,5.19812
"27246",4054,49907,49587,42,0,3,0,45,9.07498
"27247",1280,13620,13533,11,0,0,0,11,8.1285
"27248",1126,40616,34084,13,0,0,0,13,3.81411
"27249",11670,144679,143751,99,2,1,0,102,7.0956
"27251",2251,37546,37305,29,0,0,0,29,7.77373
"27252",1872,110464,27543,18,0,0,0,18,6.53519
"27254",6734,85371,85371,34,0,7,1,42,4.91969
"27256",4347,49160,48791,41,0,0,0,41,8.40326
"27258",8496,180132,140302,42,0,2,0,44,3.1361
"27259",808,13056,12972,9,0,0,0,9,6.93786
"27260",8624,256619,160047,72,0,0,0,72,4.49867
"27261",4260,68865,48486,16,0,2,0,18,3.71245
"27263",4750,105618,91273,31,2,5,0,38,4.16335
"27266",3245,57386,57018,36,0,0,0,36,6.3138
"27267",1226,40623,31087,12,0,0,0,12,3.86008
"27268",14892,61979,61581,23,0,1,0,24,3.89728
"27269",2158,57786,51025,19,0,0,0,19,3.72369
"27270",3859,50907,50581,39,0,1,0,40,7.90818
"27271",4937,39828,39828,23,0,1,0,24,6.02585
"27273",1542,20070,20070,12,0,1,0,13,6.47733
"27275",20861,143629,142708,121,404,15,0,540,37.8395
"27276",948,11679,11604,10,0,0,0,10,8.61763
"27277",3404,38449,38408,30,0,0,0,30,7.81082
"27278",10401,164198,120434,57,3,7,1,68,5.64624
"27279",21685,130055,130055,112,22,14,0,148,11.3798
"27280",4272,36430,36430,34,0,1,0,35,9.60745
"27281",1587,35141,35141,11,0,0,0,11,3.13024
"27282",3686,42665,38488,25,0,0,0,25,6.49561
"27284",58437,319347,298658,191,640,39,0,870,29.1303
"27285",1311,14199,14199,8,3,0,0,11,7.74692
"27286",3272,130205,85988,23,2,1,0,26,3.02368
"27287",4572,62296,62296,33,0,1,0,34,5.45779
"27288",5400,113671,76144,58,2,0,0,60,7.87985
"27289",621,35665,6567,3,0,0,0,3,4.56857
"27290",6204,144053,131076,65,0,3,0,68,5.18783
"27291",554,19398,10729,4,0,0,1,5,4.66045
"27294",6511,97149,96526,60,0,0,0,60,6.21594
"27295",2357,107433,51004,22,0,1,0,23,4.50946
"27297",1589,57476,22411,15,0,1,0,16,7.13922
"27298",2176,25636,23546,18,0,1,0,19,8.06934
"27299",18429,111502,89535,128,35,14,0,177,19.7688
"27300",2029,32191,27653,19,0,1,0,20,7.23261
"27301",9351,120243,99136,63,0,3,0,66,6.65751
"27302",8947,139924,139924,63,0,2,0,65,4.64538
"27304",199,2140,2126,1,0,0,0,1,4.70309
"27306",119030,611345,587760,143,13,103,0,259,4.40656
"27307",3942,68131,60056,37,0,0,0,37,6.16093
"27309",2895,48881,48568,31,0,0,0,31,6.38287
"27310",1176,13568,13481,10,7,1,0,18,13.3521
"27311",7543,107816,92551,56,3,1,0,60,6.48288
"27312",1869,32252,25719,10,0,1,0,11,4.27701
"27313",4542,52117,49562,36,0,0,0,36,7.26367
"27315",835,34505,23328,5,0,0,0,5,2.14335
"27316",8337,209284,146769,51,0,2,0,53,3.61113
"27317",5000,102894,79088,37,0,0,0,37,4.67831
"27318",2329,23124,23124,15,4,1,0,20,8.64904
"27319",2400,41040,36349,19,0,1,0,20,5.50214
"27320",1807,19395,19395,13,0,0,0,13,6.70267
"27321",2757,28682,17347,8,0,1,0,9,5.18816
"27322",5741,62611,60402,36,1,4,0,41,6.7878
"27323",2296,115450,49099,25,0,2,0,27,5.49908
"27324",1348,24485,24328,12,0,1,0,13,5.34364
"27325",2333,47742,47118,25,0,0,0,25,5.30585
"27326",2350,46431,46431,13,0,1,0,14,3.01526
"27327",1975,32707,32707,13,0,1,0,14,4.28038
"27329",2395,35586,35358,21,0,2,0,23,6.50493
"27331",1993,24604,24446,19,0,0,0,19,7.77217
"27332",13224,133774,132014,33,8,15,0,56,4.24198
"27333",3056,53757,53412,30,0,0,0,30,5.61669
"27334",823,25897,20833,10,0,0,0,10,4.80019
"27335",7629,108222,107528,39,1,3,0,43,3.99896
"27336",1805,39007,32166,17,0,0,0,17,5.28501
"27337",1777,33049,32837,17,0,0,0,17,5.17707
"27338",4346,84836,64495,40,0,1,0,41,6.3571
"27339",4094,50460,45250,30,0,1,1,32,7.07178
"27340",6127,115635,101949,44,0,0,0,44,4.31588
"27341",414,16553,9636,4,0,0,0,4,4.15121
"27342",999,30228,19869,11,0,0,0,11,5.53616
"27343",5262,97303,74868,39,3,2,0,44,5.87699
"27345",983,46534,31071,8,0,0,0,8,2.57475
"27346",1065,30079,14118,12,0,0,0,12,8.49985
"27347",6661,41956,41957,54,0,0,0,54,12.8704
"27348",10874,77986,77986,74,55,4,0,133,17.0543
"27349",8564,145913,138189,61,0,2,0,63,4.55898
"27350",3035,58611,47696,33,0,2,1,36,7.54777
"27351",5944,43715,43714,52,9,0,0,61,13.9542
"27353",5370,59173,59173,40,0,0,0,40,6.75985
"27354",2521,30443,30443,17,0,1,0,18,5.91263
"27355",5071,42200,41929,39,15,3,0,57,13.5943
"27358",2489,48575,48575,17,0,1,0,18,3.70563
"27359",1247,65850,26418,15,0,0,0,15,5.67799
"27360",1773,25419,25419,13,0,0,0,13,5.11428
"27361",5162,152947,101427,37,0,0,0,37,3.64795
"27363",1848,49709,30357,14,0,0,0,14,4.61179
"27364",1094,14002,13912,4,0,4,0,8,5.75035
"27365",7898,52127,52127,53,19,1,0,73,14.0043
"27366",1716,19825,19698,16,0,0,0,16,8.12273
"27367",9676,728745,164327,84,0,7,0,91,5.53772
"27368",1361,16956,16847,13,0,0,0,13,7.71638
"27369",714,14053,10661,6,0,0,0,6,5.62787
"27370",1442,32217,21684,13,3,0,0,16,7.37868
"27371",887,29155,18449,8,0,0,0,8,4.33629
"27372",4523,70325,69874,46,0,1,0,47,6.72639
"27373",503,37087,10929,6,0,0,0,6,5.48974
"27374",2455,52834,36405,24,0,1,0,25,6.86717
"27375",91006,457521,448580,359,469,33,3,864,19.2608
"27376",1127,15530,15430,10,0,0,0,10,6.4807
"27377",1804,17990,17875,15,10,5,0,30,16.7836
"27378",4080,98955,63763,44,0,6,0,50,7.8416
"27379",767,11741,11666,9,0,0,0,9,7.7149
"27380",2759,215416,40732,18,0,1,1,20,4.91019
"27381",1139,25265,23844,9,0,1,0,10,4.19392
"27382",2595,28073,28074,16,0,0,0,16,5.69932
"27383",1452,22943,19337,13,0,0,0,13,6.72282
"27384",4007,98887,53985,32,0,1,0,33,6.11281
"27385",29682,435574,266836,153,50,9,0,212,7.94497
"27386",5210,28281,28281,61,20,0,0,81,28.6408
"27388",2829,49992,47326,24,0,1,0,25,5.28256
"27389",4781,71087,71087,39,0,0,0,39,5.48625
"27390",8000,134764,133900,78,0,1,0,79,5.89994
"27391",8986,124932,123772,75,4,4,2,85,6.86745
"27392",1419,26746,26574,11,0,0,0,11,4.13931
"27393",9425,307379,178326,73,2,1,0,76,4.26185
"27394",2278,20863,20863,18,0,0,0,18,8.62772
"27395",201,15085,2836,1,0,1,0,2,7.05295
"27396",2863,53933,53587,30,0,3,0,33,6.15819
"27397",6886,55247,55247,66,0,1,0,67,12.1273
"27398",11252,142383,126158,95,0,14,0,109,8.63998
"27399",601,8250,8250,2,0,1,0,3,3.63637
"27400",1789,28498,25045,15,0,0,0,15,5.98924
"27401",132,1929,1929,1,0,0,0,1,5.18447
"27402",851,15033,14937,9,0,0,0,9,6.02546
"27403",168,1850,1850,2,0,0,0,2,10.8117
"27404",176,7900,7849,1,0,0,0,1,1.27399
"27405",426,8881,8824,4,0,0,0,4,4.53307
"27406",2001,17881,17881,15,0,1,0,16,8.9479
"27407",1701,20917,20783,17,0,0,0,17,8.17982
"27408",1592,27867,23740,15,0,0,0,15,6.31832
"27410",22118,108542,108542,57,0,2,0,59,5.43566
"27411",1373,18896,18775,14,0,0,0,14,7.4568
"27412",11312,180478,120641,67,2,1,0,70,5.80235
"27413",1448,44477,23028,15,1,3,0,19,8.25066
"27414",5666,82036,81510,64,12,3,0,79,9.69209
"27415",3708,209187,107535,33,11,2,0,46,4.27768
"27416",3267,56148,55788,36,0,0,0,36,6.453
"27417",5339,79478,78968,53,0,3,0,56,7.09145
"27418",1476,48920,36798,16,0,0,0,16,4.34801
"27419",2986,45361,45070,27,0,2,0,29,6.43442
"27420",1225,7011,6966,6,0,1,0,7,10.0487
"27421",1398,35735,26250,17,0,1,0,18,6.85724
"27422",2818,39089,38251,27,2,0,0,29,7.58148
"27423",2721,44625,44339,24,0,0,0,24,5.41287
"27424",26339,35447,35220,7,0,2,0,9,2.55539
"27425",20578,350739,276448,111,0,11,0,122,4.41313
"27426",7059,71351,70893,65,0,0,0,65,9.1687
"27427",2692,106118,49321,20,0,4,0,24,4.86611
"27428",40884,336232,243737,235,53,16,2,306,12.5545
"27429",676,11063,11063,6,0,0,0,6,5.42362
"27430",3856,65574,65153,36,2,0,0,38,5.83238
"27431",1399,27458,27282,13,9,1,0,23,8.43047
"27432",8701,123694,123694,61,0,0,0,61,4.93154
"27433",1263,38627,23689,16,0,0,0,16,6.75415
"27434",89,2199,2185,1,0,0,0,1,4.57686
"27435",3247,135540,71968,32,0,0,0,32,4.44645
"27436",5205,87293,80021,34,0,0,1,35,4.37388
"27437",2292,34626,34404,24,0,0,0,24,6.97594
"27438",7980,65632,62034,25,101,11,0,137,22.0848
"27439",7737,65067,65067,15,0,8,0,23,3.53483
"27440",3084,43682,43402,23,0,2,0,25,5.76012
"27441",286,16073,11673,2,0,0,0,2,1.71332
"27442",417,16671,10881,4,0,0,0,4,3.67622
"27444",1759,94664,52573,15,0,1,0,16,3.04341
"27445",929,27993,6451,6,0,1,0,7,10.8504
"27446",4992,65285,60231,35,0,2,0,37,6.14303
"27447",3086,74413,73936,29,0,2,0,31,4.19282
"27448",32638,165630,163457,92,44,16,2,154,9.42145
"27451",965,15267,15267,8,0,0,0,8,5.23997
"27453",21402,134852,133987,70,2,13,0,85,6.34389
"27454",2585,56152,38903,28,0,0,0,28,7.19741
"27455",1185,60801,29632,11,0,0,0,11,3.71223
"27456",2577,41618,22306,15,0,1,0,16,7.17308
"27457",5867,66299,65627,50,0,0,0,50,7.61883
"27458",20459,135605,135605,162,5,4,0,171,12.6102
"27459",413,8397,8343,4,0,0,0,4,4.79435
"27460",1189,30898,28486,10,0,0,0,10,3.51047
"27462",437,19143,11866,5,0,0,0,5,4.21359
"27463",4140,177883,87196,39,0,6,0,45,5.16078
"27464",6821,76288,76288,59,0,0,0,59,7.73382
"27465",1687,39423,26563,14,0,0,0,14,5.27048
"27466",2800,56402,49348,31,0,0,0,31,6.28186
"27467",113722,574662,516048,270,675,93,1,1039,20.1338
"27468",2449,48221,24889,15,0,3,0,18,7.23216
"27469",24560,170337,155138,216,32,11,1,260,16.7593
"27470",13049,72048,71586,45,11,13,1,70,9.77847
"27471",213,2624,2607,2,0,0,0,2,7.67112
"27472",2245,32017,32017,14,0,2,0,16,4.99728
"27473",2180,43282,37400,21,0,1,0,22,5.88228
"27474",2776,23471,23471,23,0,2,0,25,10.6514
"27475",1164,30569,30373,12,0,0,0,12,3.95088
"27476",1239,47440,21981,8,0,1,0,9,4.09437
"27477",2599,28929,28743,21,0,0,0,21,7.306
"27478",13411,117157,107449,82,0,8,0,90,8.37605
"27480",4513,71417,70959,40,0,3,0,43,6.05985
"27481",25539,391449,360055,26,0,317,0,343,9.52631
"27482",335,3623,3623,3,0,0,0,3,8.28083
"27483",1625,17862,17862,16,0,0,0,16,8.95758
"27485",2330,22421,22421,25,2,0,0,27,12.0423
"27486",6990,60323,60323,27,0,3,0,30,4.97326
"27487",1417,20824,20690,13,0,0,0,13,6.28311
"27488",832,33136,16421,8,0,0,1,9,5.48078
"27489",4266,57837,57837,31,0,1,0,32,5.53278
"27490",466,5122,5089,8,0,0,0,8,15.7197
"27491",408,30261,21040,4,0,0,0,4,1.90112
"27492",1625,38272,38027,20,0,0,0,20,5.25949
"27493",21543,216303,202198,228,33,16,2,279,13.7984
"27495",1499,18935,18814,15,0,0,0,15,7.97297
"27496",1820,32884,32673,19,0,0,0,19,5.81517
"27497",12781,223105,165140,100,0,2,0,102,6.17659
"27498",2207,42516,42243,25,0,0,0,25,5.91809
"27500",13101,183185,106204,70,14,4,0,88,8.28591
"27501",2792,42547,42547,26,0,0,0,26,6.11083
"27502",6662,111423,95241,66,17,8,1,92,9.65967
"27504",20293,207308,192653,159,0,6,0,165,8.56464
"27505",953,45896,34921,9,0,0,0,9,2.57727
"27507",32753,349351,303558,240,53,25,1,319,10.5087
"27508",1933,74337,43645,17,0,2,0,19,4.35327
"27511",3973,45808,45808,34,0,0,0,34,7.42234
"27512",2666,108438,68321,25,0,0,0,25,3.6592
"27514",1767,104469,38695,18,0,1,0,19,4.91017
"27516",3362,152108,72078,30,0,0,0,30,4.16218
"27517",25684,410572,290232,128,1,20,0,149,5.13382
"27518",10285,234604,139596,74,0,0,0,74,5.30102
"27520",648,35817,16485,7,0,0,0,7,4.2464
"27521",296,15094,8548,3,0,0,0,3,3.50963
"27522",4424,189158,96057,43,0,0,0,43,4.47652
"27523",2145,111700,40906,20,0,2,0,22,5.37819
"27524",11184,139213,133320,72,0,1,0,73,5.47554
"27525",2895,38710,38710,28,0,0,0,28,7.23336
"27527",510,40691,13813,7,0,0,0,7,5.06774
"27528",27271,154106,154105,162,31,10,0,203,13.1728
"27529",4017,128460,68306,22,0,2,0,24,3.51362
"27530",427,17263,9529,4,0,0,0,4,4.19792
"27531",2825,59608,53905,17,0,0,0,17,3.15368
"27533",2582,39571,39317,20,0,5,0,25,6.35853
"27534",7223,65586,59532,46,0,3,1,50,8.39887
"27535",2072,26248,26248,16,0,1,0,17,6.4767
"27536",4614,59816,59816,32,0,1,0,33,5.51695
"27537",5510,77909,57955,52,4,0,0,56,9.66268
"27538",3522,85255,59209,43,7,1,0,51,8.61359
"27539",3158,37158,36920,28,0,0,0,28,7.58403
"27540",2269,35931,29316,13,4,1,0,18,6.13994
"27541",1369,44134,36138,13,0,0,0,13,3.59735
"27542",5911,131065,123816,65,3,0,0,68,5.49203
"27543",3587,56253,55892,34,1,1,0,36,6.44097
"27544",1597,13275,13275,14,0,0,0,14,10.5459
"27545",84,3040,3040,1,0,0,0,1,3.28936
"27546",260,5545,5545,2,0,0,0,2,3.60712
"27547",6805,220316,113578,77,0,1,1,79,6.95558
"27548",4134,59835,57907,42,3,1,0,46,7.94374
"27549",12552,103524,87900,72,57,3,0,132,15.0171
"27550",1924,60001,34484,20,0,0,0,20,5.79973
"27551",125,3411,3389,1,0,0,0,1,2.95059
"27552",1689,98045,41311,16,0,1,0,17,4.11509
"27553",2477,63087,39917,30,0,0,0,30,7.51552
"27554",10271,134652,125197,84,0,0,1,85,6.78927
"27555",969,34235,15714,11,0,0,0,11,7.0003
"27556",785,50423,22584,8,0,0,0,8,3.54229
"27557",771,55032,31672,7,0,0,0,7,2.21019
"27558",1588,29420,29421,11,0,1,0,12,4.07877
"27560",3060,205398,38872,16,0,1,0,17,4.37338
"27561",18771,285437,128060,46,6,7,0,59,4.60722
"27562",120749,469076,451084,65,27,85,1,178,3.94605
"27563",6651,115900,91862,49,0,0,0,49,5.33408
"27564",2775,148669,65342,19,0,3,0,22,3.36689
"27565",8738,719280,142265,74,0,0,1,75,5.27187
"27567",722,9291,9231,8,0,0,0,8,8.66605
"27568",4297,52221,52221,28,0,0,0,28,5.36186
"27569",5208,66965,52786,12,0,1,0,13,2.46276
"27570",815,6492,6492,5,0,0,0,5,7.70124
"27571",2854,47444,47140,29,0,0,0,29,6.15193
"27572",4031,48202,48202,31,0,0,0,31,6.43125
"27576",4770,148221,147270,43,0,1,0,44,2.9877
"27577",2831,73175,57667,21,0,0,0,21,3.64157
"27578",4879,92370,83539,42,0,3,0,45,5.38672
"27579",437,4842,4842,4,0,0,0,4,8.26155
"27580",22210,213081,205866,168,5,2,0,175,8.50066
"27581",3367,83284,58756,25,0,0,0,25,4.25492
"27582",8661,79888,75054,70,4,1,0,75,9.99274
"27584",4339,64231,61120,34,0,0,0,34,5.56279
"27586",1020,22555,22555,8,0,0,0,8,3.54689
"27587",3986,134949,75682,39,2,4,0,45,5.94591
"27589",1782,31905,31700,13,0,1,0,14,4.41635
"27590",1206,28997,24369,13,0,0,0,13,5.33471
"27591",3536,151277,72551,39,0,0,0,39,5.37555
"27592",1616,34811,26514,17,0,0,0,17,6.41175
"27593",13357,116724,116724,117,5,14,0,136,11.6514
"27594",2884,79899,60384,31,0,1,0,32,5.2994
"27595",4478,66403,64063,38,0,0,0,38,5.93168
"27597",5763,105751,90022,43,0,0,0,43,4.77661
"27598",1805,18274,18274,15,14,0,0,29,15.8697
"27599",3905,68711,67153,35,3,4,0,42,6.25442
"27600",1813,68955,27025,12,0,1,0,13,4.81043
"27601",4554,121873,110976,41,0,0,0,41,3.69448
"27602",49062,330174,326185,328,169,20,0,517,15.8499
"27603",2552,86305,53631,26,0,0,0,26,4.84796
"27604",2673,72951,37804,7,0,2,0,9,2.38067
"27605",1418,92267,34843,14,0,0,0,14,4.01802
"27606",8424,166388,125951,52,4,2,0,58,4.60496
"27607",3366,78257,69472,22,0,1,0,23,3.31066
"27608",3338,62709,50956,38,0,0,0,38,7.45747
"27609",1567,54816,44101,15,0,1,0,16,3.62801
"27610",215,30537,7125,2,0,0,0,2,2.80693
"27611",1164,28535,14218,8,0,0,0,8,5.62656
"27612",4536,61023,56425,32,0,3,0,35,6.20295
"27613",4997,167363,117738,50,0,3,0,53,4.50152
"27614",1174,22302,22159,13,0,0,0,13,5.86669
"27615",1627,14697,14697,13,0,0,0,13,8.84551
"27616",9447,80394,76390,65,0,2,0,67,8.7708
"27617",3337,35669,35440,37,0,0,0,37,10.4401
"27618",6744,111819,109560,56,0,1,0,57,5.20261
"27620",4094,89895,87267,30,0,1,0,31,3.55234
"27621",1256,38269,21786,5,0,10,0,15,6.88501
"27622",9978,128416,118549,79,32,8,1,120,10.1224
"27623",5107,47300,47300,42,0,0,0,42,8.87943
"27624",6150,65529,65529,55,0,0,0,55,8.39323
"27625",3207,41596,41329,37,0,0,0,37,8.9525
"27627",2766,62404,51082,19,0,2,0,21,4.11101
"27629",10547,126680,107546,129,4,8,0,141,13.1107
"27630",1787,44844,30616,17,0,1,0,18,5.87922
"27631",3861,57469,57469,34,0,0,0,34,5.91627
"27632",2804,38868,38619,31,0,0,0,31,8.02719
"27633",1643,17519,17407,16,8,0,0,24,13.7878
"27635",1607,28205,28024,16,0,0,0,16,5.70938
"27638",42323,461010,390274,259,6,11,1,277,7.09758
"27640",779,15764,15663,8,0,0,0,8,5.1076
"27641",3068,61708,44456,26,0,0,0,26,5.84845
"27642",1360,35042,23091,13,0,3,0,16,6.92905
"27643",19215,69218,64584,6,0,18,0,24,3.71607
"27644",1616,33227,21877,16,0,1,0,17,7.77078
"27645",1920,37299,31916,12,0,2,0,14,4.38646
"27646",7187,145325,92967,59,0,1,0,60,6.45393
"27649",1945,27953,27774,20,0,0,0,20,7.20103
"27650",9025,130242,111226,48,0,2,1,51,4.58525
"27651",106,1744,1744,0,0,1,0,1,5.73412
"27652",2799,37732,37732,19,0,0,0,19,5.03549
"27654",15687,200235,196476,100,0,3,0,103,5.24238
"27655",7917,204296,146444,50,0,3,0,53,3.61913
"27656",12123,287231,130844,87,4,1,1,93,7.10769
"27657",2697,56019,48927,20,0,0,0,20,4.08775
"27658",3160,61606,45038,22,0,0,0,22,4.88481
"27659",1553,18883,18883,9,0,0,0,9,4.76618
"27660",5179,133079,95682,21,4,5,0,30,3.13539
"27661",4509,68418,44886,16,6,9,0,31,6.90638
"27662",4402,155123,119586,34,0,0,0,34,2.84315
"27663",1402,28564,24243,12,0,0,0,12,4.94988
"27664",3738,78422,75653,34,0,1,0,35,4.62641
"27665",7623,217146,138364,52,0,4,0,56,4.04728
"27666",3419,40152,40152,26,0,0,0,26,6.47538
"27667",2673,43034,43034,20,0,0,0,20,4.64752
"27668",1114,20968,20968,8,0,0,0,8,3.81539
"27669",5010,180606,73803,35,0,0,0,35,4.74236
"27670",4360,68937,68495,43,0,1,0,44,6.42384
"27671",2616,71001,53154,17,0,1,0,18,3.3864
"27672",340,4494,4465,3,4,0,0,7,15.6768
"27673",935,8569,8514,7,0,0,0,7,8.22174
"27674",2795,32023,32023,18,0,0,0,18,5.62105
"27676",7288,138289,99657,64,0,5,0,69,6.92376
"27677",3992,48942,48942,32,0,0,0,32,6.5384
"27678",5251,55777,55777,40,0,0,0,40,7.17143
"27679",94368,665246,636029,341,114,52,1,508,7.98706
"27680",1425,43366,22442,13,0,1,0,14,6.23827
"27681",131305,666295,586634,452,784,82,1,1319,22.4842
"27682",2068,24310,24154,23,0,0,0,23,9.5222
"27683",832,24011,23857,7,14,0,0,21,8.80247
"27684",49509,217662,217662,26,3,91,0,120,5.51314
"27685",2345,55535,41685,23,0,2,0,25,5.99737
"27686",560,21238,11518,4,0,0,0,4,3.47296
"27689",2265,25722,25722,18,0,0,0,18,6.99788
"27690",2168,33699,33483,23,0,0,0,23,6.8692
"27691",4785,60490,60102,47,0,0,0,47,7.82003
"27692",1241,25170,15297,7,0,0,0,7,4.57594
"27693",10793,225982,169023,55,0,7,0,62,3.66815
"27694",1610,24080,24080,14,0,0,1,15,6.22926
"27695",1106,15127,15127,7,0,0,0,7,4.62758
"27696",3874,79865,41498,30,0,0,1,31,7.47024
"27697",29475,141333,141333,17,0,7,0,24,1.69812
"27698",6461,57158,57158,40,0,3,0,43,7.52296
"27699",1364,22507,19617,11,0,0,1,12,6.11706
"27700",5340,71207,66065,37,0,1,0,38,5.7519
"27701",79901,466333,445809,247,315,56,1,619,13.8849
"50002",77866,400525,388785,125,132,68,3,328,8.43655
"50003",43338,270370,247569,294,61,23,3,381,15.3896
"50004",5931,118073,90080,30,0,3,0,33,3.66342
"50006",2201,62569,55737,11,0,1,0,12,2.15297
"50007",1185,34340,22773,8,0,0,0,8,3.51288
"50008",2545,26025,26025,16,12,0,0,28,10.7587
"50013",3193,37787,33306,23,0,0,0,23,6.90566
"50014",2346,33816,29147,17,0,1,0,18,6.17552
"50015",9731,93828,91029,69,5,1,1,76,8.34903
"50016",834,24297,16129,8,0,0,0,8,4.96007
"50019",3662,42032,35421,23,5,1,0,29,8.1873
"50021",870,22620,16149,4,0,0,0,4,2.477
"50022",916,16158,16158,7,0,0,0,7,4.33234
"50023",6882,101070,101070,37,0,1,0,38,3.75977
"50024",2584,72787,40114,15,0,1,0,16,3.9886
"50025",26483,140193,136306,91,90,36,1,218,15.9934
"50026",535,5698,5698,3,0,0,0,3,5.26504
"50027",16275,296869,183858,108,0,2,0,110,5.98288
"50028",211,4276,4276,1,0,0,0,1,2.33859
"50029",9694,134631,71232,36,14,5,0,55,7.72122
"50030",4749,23546,23546,32,37,4,0,73,31.0032
"50031",35051,294433,273461,239,58,21,2,320,11.7018
"50032",10295,115762,113872,63,0,3,0,66,5.79598
"50033",2194,24505,24505,15,0,0,0,15,6.12114
"50034",8955,95853,95853,62,0,0,0,62,6.46821
"50036",2268,32567,28026,20,0,0,0,20,7.13627
"50038",3846,48698,39690,29,0,1,0,30,7.55854
"50039",1316,33827,29322,7,0,1,0,8,2.72835
"50040",852,10519,10519,8,0,0,0,8,7.60527
"50041",131948,1679383,1234817,809,18,52,1,880,7.12656
"50042",7530,47984,47984,16,0,6,0,22,4.58484
"50044",3688,75852,58312,25,0,0,2,27,4.63026
"50045",11062,221575,106311,56,0,5,1,62,5.83193
"50046",7683,118244,105073,40,0,1,0,41,3.90204
"50048",7284,119790,95471,52,0,1,0,53,5.55142
"50049",7431,143863,128546,57,0,2,0,59,4.58981
"50050",277,1747,1747,1,0,0,0,1,5.72549
"50052",923,21816,21816,6,0,0,0,6,2.75025
"50054",2503,37419,37419,17,0,1,0,18,4.81042
"50055",1106,35233,20904,8,0,0,0,8,3.82702
"50058",33950,323653,281997,231,0,12,0,243,8.61711
"50059",4274,71384,61793,28,0,0,0,28,4.53125
"50060",4171,111598,91352,25,0,1,0,26,2.84614
"50062",644,14785,14785,3,0,0,0,3,2.0291
"50064",2452,45224,41852,18,0,1,0,19,4.53978
"50066",40836,390567,350269,267,92,6,0,365,10.4206
"50069",5563,84163,81791,32,0,2,0,34,4.15691
"50070",379,3530,3530,3,0,0,0,3,8.4991
"50072",3534,66143,63649,27,0,0,0,27,4.24202
"50074",28974,293052,260118,153,20,13,1,187,7.18905
"50076",47736,301574,260029,304,121,24,3,452,17.3827
"50077",8270,77258,74130,55,0,2,0,57,7.68919
"50078",10804,123517,116910,77,0,0,0,77,6.58627
"50079",3242,45507,45507,22,0,1,0,23,5.05413
"50081",14281,193538,110878,76,0,2,0,78,7.03473
"50082",55908,651625,594586,290,22,25,0,337,5.66781
"50083",8840,153243,130749,38,0,7,0,45,3.4417
"50084",5490,76772,55458,44,0,0,0,44,7.93391
"50085",17879,189814,178532,142,0,3,1,146,8.17781
"50086",4204,100889,65489,30,0,0,0,30,4.58093
"50087",24738,221757,208927,91,0,27,0,118,5.6479
"50088",629,18246,18247,3,0,0,0,3,1.64415
"50090",3922,67583,33043,21,0,1,0,22,6.65802
"50092",6022,83027,83027,41,0,0,0,41,4.93818
"50093",3390,51002,46176,25,0,1,0,26,5.63068
"50094",3813,56251,56251,31,0,0,0,31,5.51104
"50095",16684,265074,142655,83,5,16,3,107,7.50059
"50096",2368,40844,36186,19,0,0,0,19,5.25069
"50097",1530,12492,12492,6,0,0,0,6,4.80311
"50098",5234,106116,102036,40,0,1,0,41,4.01819
"50099",70887,768537,539074,273,59,38,3,373,6.91928
"50101",892,14173,14173,7,0,0,0,7,4.93896
"50102",11491,84288,84289,72,17,5,0,94,11.1522
"50103",4351,42466,32303,14,0,1,0,15,4.64359
"50105",479,12850,7332,3,0,0,0,3,4.09138
"50106",17956,121461,121461,13,0,2,0,15,1.23496
"50107",7125,96105,63078,10,0,5,0,15,2.37801
"50108",6270,69615,48998,23,0,2,0,25,5.10224
"50109",17510,153530,146521,103,2,11,0,116,7.91697
"50110",11308,170230,143169,61,3,4,1,69,4.81947
"50111",6879,103373,100316,52,0,0,0,52,5.18362
"50112",2882,72961,57558,17,0,3,0,20,3.47478
"50115",6353,115192,106861,36,0,0,0,36,3.36885
"50117",5587,54124,49736,32,0,1,0,33,6.635
"50118",6645,93903,93903,31,0,11,0,42,4.47271
"50120",4238,82495,77534,25,0,1,0,26,3.35335
"50121",2276,59701,45108,14,0,2,0,16,3.54706
"50124",1408,49500,28079,12,0,1,0,13,4.62985
"50126",2544,30370,30370,16,0,0,0,16,5.26835
"50129",466895,2507799,2231662,1476,1689,439,14,3618,16.2121
"50130",3384,73743,47156,21,0,0,0,21,4.45331
"50135",5729,63806,58543,20,0,3,0,23,3.92874
"50137",14927,186983,143950,53,0,13,0,66,4.58494
"50138",4992,65123,62530,37,0,1,0,38,6.07705
"50139",47906,735406,563869,270,6,14,1,291,5.16077
"50140",4020,72002,51480,34,0,0,0,34,6.60453
"50142",8140,138866,85533,62,0,4,0,66,7.71633
"50143",6387,58425,58425,44,4,0,0,48,8.21571
"50144",2489,39047,34120,15,0,1,0,16,4.68928
"50145",4826,80053,72842,36,0,0,1,37,5.0795
"50146",1254,34288,19256,8,0,1,0,9,4.67382
"50147",88240,412048,390908,185,146,67,3,401,10.2582
"50148",5012,68707,66028,34,0,2,0,36,5.45224
"50149",14118,133082,122466,113,0,4,0,117,9.55367
"50150",2917,60932,57824,26,0,0,0,26,4.49637
"50151",37118,300769,296221,174,19,13,3,209,7.05554
"50152",490,7850,7850,3,0,0,0,3,3.8218
"50155",3836,63480,58508,27,0,0,0,27,4.61474
"50156",174,4507,4507,2,0,0,0,2,4.43717
"50158",2219,107145,33960,5,6,2,0,13,3.82804
"50159",5055,66541,66541,25,0,3,0,28,4.20793
"50160",14137,171440,162724,102,3,6,0,111,6.82137
"50161",7778,230140,94411,22,0,5,0,27,2.85982
"50162",9092,91574,91574,57,1,1,0,59,6.44288
"50164",15822,173734,155304,91,0,4,0,95,6.11702
"50165",21975,93328,93328,136,32,5,0,173,18.5368
"50166",2944,67099,55400,18,0,0,0,18,3.24909
"50167",10843,148904,126998,63,0,5,0,68,5.35441
"50168",29814,257695,242846,177,12,13,0,202,8.31805
"50169",9224,91434,71851,7,0,0,0,7,0.974235
"50172",3065,44432,44432,20,0,1,0,21,4.72635
"50174",2361,25766,25766,19,0,0,0,19,7.37393
"50175",1206,12893,12893,9,0,0,0,9,6.98056
"50176",3270,60079,56410,21,0,1,1,23,4.07731
"50177",3654,61785,58767,31,0,1,0,32,5.44521
"50178",6652,81144,73716,46,0,1,0,47,6.37582
"50181",4581,64673,53996,25,0,2,0,27,5.0004
"50182",3867,72097,52696,26,0,1,0,27,5.12375
"50183",2702,58279,40387,22,0,0,0,22,5.44732
"50184",13072,105875,101302,116,2,4,0,122,12.0433
"50185",16136,238394,212631,100,6,4,0,110,5.17328
"50186",1480,48130,19805,11,0,0,0,11,5.55429
"50188",11775,166348,139862,97,0,1,0,98,7.00692
"50190",1659,23042,23042,13,0,0,0,13,5.64195
"50192",2404,37097,37097,17,0,0,0,17,4.58261
"50193",1099,18803,18803,8,0,0,0,8,4.25473
"50194",2360,45261,40746,15,0,0,0,15,3.68135
"50195",1253,32486,32486,10,0,0,0,10,3.07821
"50196",4089,51896,51896,26,0,0,0,26,5.00998
"50197",15884,164744,126577,99,1,10,0,110,8.69034
"50198",2671,87465,40232,20,0,0,0,20,4.9712
"50199",5647,89703,67726,33,0,4,0,37,5.46318
"50200",7831,584478,85980,41,3,2,0,46,5.35011
"50205",4947,75206,75206,38,0,0,0,38,5.05279
"50206",1836,28538,28538,10,0,1,0,11,3.85453
"50207",1021,20154,20154,6,0,0,0,6,2.97706
"50208",1066,26371,21837,7,0,0,0,7,3.20556
"50209",12655,194183,172057,79,0,4,0,83,4.82397
"50210",1481,53989,26085,9,0,1,0,10,3.83367
"50214",2945,74254,56715,16,0,1,0,17,2.99745
"50215",39827,374866,362175,275,13,11,2,301,8.3109
"50216",7952,145519,127890,43,0,3,0,46,3.59684
"50217",5467,93448,82611,33,0,1,0,34,4.11569
"50218",116996,470588,470588,434,672,96,0,1202,25.5425
"50219",8082,134454,84879,43,0,3,0,46,5.41947
"50221",319,9737,9737,3,0,0,0,3,3.08093
"50222",14990,120444,115902,66,0,4,0,70,6.03961
"50223",408,13064,8122,4,0,0,0,4,4.92511
"50225",219,9703,9703,2,0,0,0,2,2.06132
"50227",1792,31869,26712,22,0,0,0,22,8.23615
"50228",9413,117918,117918,55,0,5,0,60,5.08828
"50230",4176,73124,58951,27,0,2,0,29,4.91936
"50231",8480,54369,54369,64,14,5,0,83,15.2659
"50232",4377,75268,66421,29,0,1,0,30,4.51665
"50233",1627,24279,24279,12,0,0,0,12,4.94256
"50235",4549,88969,77994,32,0,3,0,35,4.48753
"50236",50798,559732,495132,247,7,27,1,282,5.69545
"50237",9882,59286,59286,56,20,10,0,86,14.506
"50238",4495,47389,47389,14,0,1,0,15,3.16528
"50239",24170,301605,246804,134,0,7,0,141,5.71303
"50240",7857,79727,79727,62,0,1,0,63,7.90201
"50241",1101,23325,22004,7,0,1,0,8,3.6357
"50243",4257,78113,69552,32,0,0,0,32,4.60088
"50244",5704,46425,46425,30,0,3,0,33,7.10823
"50246",901,23715,13610,7,0,0,0,7,5.14334
"50247",1823,48370,34715,14,0,0,0,14,4.03279
"50248",1938,77271,36562,9,0,2,0,11,3.00861
"50251",2065,40776,33737,14,0,0,0,14,4.14969
"50252",13182,169209,151374,84,0,5,0,89,5.87946
"50253",1817,34555,31143,17,0,1,0,18,5.77976
"50256",40405,882420,616026,205,1,15,0,221,3.58751
"50258",917,16274,16274,8,0,0,0,8,4.91574
"50259",7963,177410,88681,60,0,0,0,60,6.76584
"50260",15976,220161,172265,55,3,11,1,70,4.0635
"50261",683,9417,9417,4,0,0,0,4,4.24742
"50262",4302,65197,65197,29,0,0,0,29,4.44804
"50263",1236,39335,28234,9,0,1,0,10,3.54181
"50265",849,14202,14202,5,0,0,0,5,3.52072
"50266",2621,40226,29907,19,0,0,0,19,6.35302
"50267",26866,309790,247711,164,11,27,1,203,8.19503
"50268",2061,26194,26194,14,0,1,0,15,5.72645
"50269",3251,155617,49994,14,0,1,0,15,3.00036
"50270",4571,101001,52087,31,0,1,0,32,6.1436
"50271",540,10729,10729,4,0,0,0,4,3.72808
"50272",29660,193144,173163,112,0,8,2,122,7.0454
"50273",7588,108518,97509,49,0,0,1,50,5.12774
"50274",8734,102351,89458,67,0,1,0,68,7.60134
"50275",370,7649,7649,3,0,0,0,3,3.92221
"50276",3708,75823,59361,23,0,1,0,24,4.04307
"50277",11503,70144,70144,40,0,9,0,49,6.98565
"50278",4232,41550,41550,33,1,0,0,34,8.18295
"50279",8149,157822,116886,37,0,1,1,39,3.33657
"50281",7014,94203,94203,57,0,1,0,58,6.15695
"50282",3056,51224,46476,22,0,0,0,22,4.73366
"50283",1225,12533,12533,10,0,0,0,10,7.97878
"50285",3961,94350,67012,21,0,1,0,22,3.28301
"50288",14963,99762,91515,97,13,3,0,113,12.3477
"50289",4243,73024,67108,20,0,2,2,24,3.57635
"50290",2901,83581,46114,15,0,1,0,16,3.46965
"50291",100,7987,7987,1,0,0,0,1,1.25208
"50292",45001,362118,356144,212,3,19,0,234,6.57038
"50294",19123,132897,120681,76,2,19,0,97,8.03769
"50295",719,16451,10470,6,0,0,0,6,5.73071
"50296",79,1112,1112,1,0,0,0,1,8.9904
"50297",6073,91307,72002,43,0,0,0,43,5.97206
"50298",4759,66315,66315,22,0,3,0,25,3.76989
"50299",2396,34181,27264,17,0,0,0,17,6.23544
"50300",630,9807,9807,4,0,0,0,4,4.07866
"50301",1731,38193,20304,12,0,0,0,12,5.9103
"50302",1590,17517,17517,12,0,0,0,12,6.8505
"50304",2230,38404,32494,18,0,0,0,18,5.53952
"50305",9283,122295,99603,54,0,1,1,56,5.62233
"50308",4344,78691,70168,29,0,0,0,29,4.13294
"50310",1715,29684,29684,14,0,0,0,14,4.71637
"50311",2216,36985,36986,14,0,2,0,16,4.32602
"50312",2875,21830,21830,5,0,0,0,5,2.29041
"50313",1681,33865,33865,11,0,0,0,11,3.24818
"50315",2761,47887,47887,10,0,0,0,10,2.08826
"50317",4573,68447,63708,29,0,0,0,29,4.55203
"50320",1528,22621,18776,12,0,0,0,12,6.39125
"50321",8616,132150,107117,48,0,1,0,49,4.57442
"50324",1141,28178,28178,7,0,0,0,7,2.48418
"50326",790,7468,5608,9,0,0,0,9,16.0498
"50327",2527,226877,33671,16,0,0,0,16,4.75184
"50328",12236,224469,210517,81,0,0,0,81,3.84767
"50332",8755,133723,108777,68,0,5,0,73,6.711
"50334",1297,29326,29326,8,0,1,0,9,3.06891
"50335",4363,69217,69217,25,0,0,0,25,3.61184
"50336",1296,28910,24518,7,0,0,0,7,2.85503
"50338",2228,52651,32051,10,0,1,0,11,3.43206
"50340",652,19794,9938,4,0,0,0,4,4.02511
"50341",20963,169650,169650,109,15,18,0,142,8.37018
"50342",8315,135985,107467,65,0,2,0,67,6.2345
"50345",7792,106032,88022,51,0,0,0,51,5.79399
"50347",2354,57327,36334,13,0,0,0,13,3.57795
"50348",6921,120627,102663,44,0,3,0,47,4.57808
"50349",25631,216891,211808,187,0,7,0,194,9.15922
"50350",4124,57969,57969,30,0,0,0,30,5.17521
"50352",2510,45301,45301,15,0,0,0,15,3.31115
"50353",312,831,831,0,0,1,0,1,12.0404
"50354",6127,76175,76175,44,0,2,0,46,6.03871
"50356",7847,137976,108855,42,0,5,0,47,4.31768
"50357",144,5879,5879,1,0,0,0,1,1.70093
"50358",3604,53698,51338,26,0,1,0,27,5.25931
"50359",20291,245537,240531,99,4,11,0,114,4.73951
"50360",1769,34661,34661,11,0,1,0,12,3.46212
"50361",3573,61153,42954,26,0,1,0,27,6.28572
"50362",2273,28257,28257,13,0,0,0,13,4.60059
"50363",20946,276785,222423,109,5,11,0,125,5.61991
"50364",6256,119228,107982,49,0,0,0,49,4.53777
"50365",6479,102282,83615,49,0,1,0,50,5.97975
"50368",796,9910,9910,3,0,1,0,4,4.03621
"50369",4506,78962,72701,30,0,1,1,32,4.40156
"50370",5234,98154,90705,41,0,0,0,41,4.52013
"50371",2862,28464,27957,16,9,5,0,30,10.7307
"50372",1871,24730,24730,10,0,0,0,10,4.04373
"50373",382,4750,4749,3,0,0,0,3,6.31646
"50376",3593,31641,31641,29,0,1,0,30,9.48148
"50378",4077,39327,37962,28,0,0,0,28,7.37575
"50379",1159,16291,16291,10,0,0,0,10,6.13855
"50382",2140,23568,23568,15,0,2,0,17,7.21317
"50384",1462,29923,22003,8,0,1,0,9,4.09031
"50387",2029,34732,32052,18,0,1,0,19,5.92795
"50388",10380,153166,132989,73,0,4,0,77,5.78996
"50389",3419,48200,45611,25,0,1,0,26,5.70032
"50390",1662,21621,21621,10,0,1,0,11,5.08765
"50391",23572,321000,248783,145,40,7,0,192,7.71756
"50393",26254,409313,266955,136,8,10,0,154,5.76876
"50394",27076,169254,140705,74,11,19,2,106,7.53348
"50395",1159,19385,17028,9,0,0,0,9,5.28528
"50397",898,50745,19765,6,0,0,0,6,3.03572
"50398",2578,44518,40056,17,0,1,0,18,4.49373
"50399",1876,22683,22683,13,0,0,0,13,5.73107
"50400",26199,543802,341425,160,5,9,0,174,5.09628
"50401",10043,160475,146136,67,0,4,0,71,4.85848
"50402",39959,290576,280509,163,16,32,0,211,7.52204
"50403",20861,204511,202353,117,6,8,0,131,6.47382
"50405",819,39125,17455,6,0,0,0,6,3.4375
"50407",25967,206643,167127,67,0,15,0,82,4.90644
"50408",8046,55529,55529,25,0,6,0,31,5.58263
"50409",10539,202965,77323,62,0,2,0,64,8.27697
"50410",23545,291779,225626,137,48,15,0,200,8.86424
"50411",14787,138848,102156,46,0,15,0,61,5.97127
"50412",26963,264896,225724,204,0,10,1,215,9.52489
"50413",8025,122003,101460,67,0,0,0,67,6.60356
"50417",17030,143524,143524,103,14,11,0,128,8.91834
"50419",23149,255335,253420,166,1,7,0,174,6.86608
"50420",11213,195931,120173,56,0,3,0,59,4.90957
"50421",1931,34031,20899,12,0,3,0,15,7.17744
"50422",3100,120976,53984,8,0,3,0,11,2.03765
"50423",10735,46231,46231,15,0,8,0,23,4.97496
"50425",11507,174980,156147,71,0,1,0,72,4.61103
"50426",2054,41039,29681,15,0,0,0,15,5.05377
"50427",3752,26119,24700,24,0,1,0,25,10.1216
"50428",4937,65381,61688,25,0,3,0,28,4.53896
"50429",8263,105462,84576,60,3,0,0,63,7.44896
"50430",258,4869,4869,3,0,0,0,3,6.16143
"50431",12724,224973,199349,85,0,1,0,86,4.31405
"50433",9992,116222,106003,69,10,0,0,79,7.45259
"50435",4434,64745,52913,31,0,0,0,31,5.85872
"50436",9698,302879,122867,60,0,1,0,61,4.96473
"50437",6465,62214,62214,39,0,1,0,40,6.42937
"50438",3645,75369,59639,21,0,1,0,22,3.68883
"50442",1969,12482,12482,18,0,1,0,19,15.2224
"50443",3090,76708,36888,26,0,0,0,26,7.0483
"50444",34610,413768,387213,165,4,13,2,184,4.75191
"50445",3658,50117,50117,20,0,0,0,20,3.99068
"50446",7500,89749,74011,45,0,0,1,46,6.21526
"50447",4339,153394,57552,34,0,0,0,34,5.90773
"50448",3464,74475,52154,26,0,0,0,26,4.98521
"50449",1918,91220,32669,13,0,0,0,13,3.97932
"50450",4239,56479,56479,17,0,3,0,20,3.54116
"50451",2439,27278,27278,11,0,1,0,12,4.39907
"50452",6328,86331,82280,41,0,0,0,41,4.98299
"50453",8568,195870,100904,58,2,4,0,64,6.34267
"50454",6294,92134,80539,46,0,0,0,46,5.71149
"50455",8089,63164,61414,50,0,5,1,56,9.11842
"50456",5775,239731,73495,32,0,1,1,34,4.62613
"50457",1434,45362,34983,12,0,1,0,13,3.71608
"50461",1235,21071,21071,9,0,1,0,10,4.74576
"50462",3022,71762,47600,19,0,0,0,19,3.99163
"50463",4531,45725,39290,33,0,1,0,34,8.65353
"50464",6341,57476,57476,39,0,2,0,41,7.13342
"50467",5756,105374,80982,27,0,0,0,27,3.33409
"50468",7532,88062,81682,47,2,3,0,52,6.36616
"50469",1255,17223,17223,7,0,0,0,7,4.06435
"50471",6908,75376,70395,98,0,2,0,100,14.2056
"50472",1084,18904,18904,6,0,0,0,6,3.17389
"50473",2655,39619,39619,20,0,2,0,22,5.55286
"50474",7059,56774,56774,37,6,3,0,46,8.10225
"50475",9224,82811,73022,41,0,5,2,48,6.5734
"50476",1399,32592,32592,10,0,0,0,10,3.0682
"50478",3459,45968,45968,26,0,1,0,27,5.87361
"50479",900,18291,18291,7,0,0,0,7,3.827
"50480",8866,126495,120268,59,0,4,0,63,5.23828
"50481",18728,162370,162370,139,3,7,0,149,9.17659
"50482",664,17748,9566,6,0,0,0,6,6.27226
"50483",15978,124773,124773,73,0,4,1,78,6.25136
"50484",64687,614021,468647,254,23,28,1,306,6.52943
"50485",31807,327747,203998,75,0,19,2,96,4.70594
"50486",7136,228037,133535,54,0,0,0,54,4.04388
"50487",41437,791441,383974,169,3,19,1,192,5.00034
"50488",5528,64185,64185,37,0,0,0,37,5.76463
"50489",5206,36604,36604,39,0,0,0,39,10.6547
"50490",10989,116979,100224,63,0,2,0,65,6.48546
"50491",6554,73122,73122,31,0,2,1,34,4.64978
"50492",33363,499496,452242,217,3,4,0,224,4.9531
"50493",15609,214164,173991,97,0,8,0,105,6.03481
"50495",112,4304,4304,1,0,0,0,1,2.3236
"50496",6466,67984,67984,43,5,3,0,51,7.50181
"50498",6653,83150,75566,45,0,2,0,47,6.21969
"50499",3624,67524,67524,23,0,2,0,25,3.70239
"50500",6465,165670,71935,41,0,1,0,42,5.83863
"50502",203882,1093398,1071204,599,710,164,15,1488,13.8909
"50503",6649,66001,66001,50,0,1,1,52,7.8787
"50504",4013,158010,57965,16,0,0,0,16,2.76028
"50505",9362,152967,121991,67,0,2,0,69,5.65617
"50506",7769,114861,67486,58,0,1,0,59,8.74261
"50507",2215,37012,35418,21,3,1,0,25,7.0585
"50509",5320,120616,79444,24,0,6,0,30,3.77626
"50510",5788,105544,94580,38,0,2,0,40,4.22924
"50511",1703,33394,23712,13,0,0,0,13,5.48249
"50512",3218,67040,51518,18,0,1,0,19,3.68806
"50513",1244,19351,19351,9,0,0,0,9,4.65087
"50514",2878,120107,54912,22,0,0,0,22,4.00638
"50516",60644,289897,289897,209,3,47,0,259,8.9342
"50517",820,21074,10931,6,0,0,0,6,5.48889
"50518",2976,154151,49068,11,0,1,0,12,2.44557
"50519",8815,93468,93468,65,0,2,0,67,7.16824
"50521",1727,167633,26654,12,0,0,0,12,4.50209
"50522",2805,37278,37278,20,0,1,0,21,5.63334
"50523",36090,969678,292903,121,16,22,1,160,5.46256
"50524",2170,60271,36327,16,0,0,0,16,4.40444
"50525",3298,129339,24514,9,0,1,0,10,4.07932
"50528",4351,65762,63637,24,0,0,0,24,3.7714
"50529",255,5031,5031,1,0,0,0,1,1.98785
"50531",8139,97640,85280,45,0,2,0,47,5.51128
"50532",59278,516025,347533,294,101,32,1,428,12.3154
"50533",1740,48512,29706,11,0,0,0,11,3.703
"50535",10734,214456,174284,60,0,2,0,62,3.5574
"50536",648,5597,5597,5,0,0,0,5,8.93402
"50537",8057,46919,46919,51,0,4,0,55,11.7223
"50538",5042,61196,61196,32,0,1,0,33,5.3925
"50539",16832,170333,157191,76,10,13,1,100,6.36169
"50540",9244,137264,134182,53,1,4,0,58,4.32249
"50541",16025,133038,133038,119,8,7,0,134,10.0723
"50542",3603,85384,72057,27,0,1,0,28,3.88583
"50543",11955,103719,101778,80,0,9,0,89,8.74449
"50546",29337,342142,318608,196,5,5,0,206,6.46562
"50548",1171,16772,13311,9,0,0,0,9,6.7614
"50549",3639,52088,48466,31,0,0,0,31,6.39618
"50550",16426,169468,152073,104,5,11,0,120,7.89097
"50551",21734,242070,204121,118,9,16,1,144,7.05465
"50552",3278,49742,38715,20,0,0,0,20,5.16599
"50553",5070,110943,72244,15,8,1,0,24,3.32207
"50554",22943,153086,132583,139,6,15,0,160,12.0679
"50556",8182,85403,85404,65,0,1,0,66,7.72802
"50562",16306,88810,88810,102,15,19,1,137,15.4262
"50563",1567,99780,38752,11,0,0,0,11,2.83854
"50564",8523,187607,93296,58,0,2,1,61,6.53835
"50565",47162,617024,436814,226,48,30,0,304,6.95948
"50567",4214,77646,68592,26,0,0,0,26,3.79054
"50568",4461,71938,66605,25,0,5,0,30,4.50415
"50569",7170,116541,93766,48,0,2,0,50,5.3324
"50570",717,37156,7338,7,0,0,0,7,9.53986
"50571",245,5128,5128,2,0,0,0,2,3.90045
"50572",1773,43925,35608,13,0,2,0,15,4.2126
"50573",1394,29648,23429,11,0,0,0,11,4.69497
"50574",2357,25293,25293,9,0,2,0,11,4.349
"50575",8848,69191,69191,66,0,3,0,69,9.97246
"50576",8431,85147,84209,73,2,2,0,77,9.14394
"50577",2297,45874,45874,16,0,0,0,16,3.4878
"50578",1588,28958,28958,10,0,0,0,10,3.45328
"50579",8411,162620,159253,52,0,4,0,56,3.51642
"50580",6690,102025,92310,48,0,0,0,48,5.19989
"50581",5474,99064,95375,36,0,0,0,36,3.77457
"50582",20404,232259,208946,110,10,10,0,130,6.2217
"50583",2548,47810,42270,23,0,0,0,23,5.44127
"50584",5228,75977,69689,29,0,2,0,31,4.44836
"50585",23222,254666,248091,179,0,7,0,186,7.49725
"50588",7202,123230,110543,48,0,1,0,49,4.43266
"50589",1253,39912,24054,9,0,0,0,9,3.74158
"50590",5131,101771,78642,40,0,0,0,40,5.08635
"50591",20367,264319,136882,66,4,10,0,80,5.84445
"50592",18582,194084,176554,109,21,10,0,140,7.9296
"50593",6476,82341,82341,42,0,0,0,42,5.10075
"50594",13355,166309,137103,88,0,4,0,92,6.71027
"50596",2856,73313,68880,22,0,0,0,22,3.19398
"50597",6469,238038,113596,39,0,2,0,41,3.60928
"50598",1256,24946,19393,11,0,0,0,11,5.6721
"50599",23270,260308,248899,137,0,7,0,144,5.78549
"50601",63746,767955,576397,234,0,21,4,259,4.49343
"50603",15100,107693,107693,130,0,7,0,137,12.7213
"50604",15129,181838,157579,61,6,9,2,78,4.94989
"50605",9323,176295,146409,62,0,7,1,70,4.78112
"50606",4132,67695,67695,29,0,0,0,29,4.2839
"50607",4103,81867,67328,27,0,1,0,28,4.15872
"50609",685,9279,9279,5,0,0,0,5,5.38864
"50610",1223,29109,21751,10,0,0,0,10,4.59746
"50612",5544,114507,57841,44,0,0,0,44,7.60706
"50613",3263,55208,55208,22,0,1,0,23,4.16604
"50615",64328,451242,411031,270,113,60,5,448,10.8994
"50616",21098,237215,186960,136,9,5,0,150,8.0231
"50617",2769,77567,65616,18,0,1,0,19,2.89564
"50618",2115,28546,28546,11,0,1,1,13,4.55398
"50619",2418,53472,42997,18,0,1,0,19,4.41896
"50621",497,4231,4231,3,0,0,0,3,7.09017
"50622",5861,142667,103829,31,0,1,0,32,3.08198
"50624",4619,62808,58843,32,0,1,0,33,5.60817
"50626",3060,70895,48440,21,0,1,0,22,4.54166
"50628",1265,17477,14785,7,0,0,0,7,4.73442
"50629",10997,275716,142492,60,0,0,0,60,4.21076
"50633",455,15386,11547,4,0,0,0,4,3.46406
"50634",852,16422,16422,7,0,0,0,7,4.26252
"50637",3341,31623,31623,21,0,2,0,23,7.27317
"50639",24649,227675,202497,120,117,32,0,269,13.2841
"50641",9622,139165,120735,55,0,3,0,58,4.80392
"50643",10483,114840,89340,53,0,6,0,59,6.60397
"50647",20045,107506,99787,117,0,6,0,123,12.3263
"50648",8611,119272,85743,63,0,1,0,64,7.46414
"61001",188673,769150,675915,390,491,234,5,1120,16.5701
"61002",3328,69591,49736,39,5,0,0,44,8.84672
"61005",3625,62170,51498,21,0,2,0,23,4.46618
"61006",116473,577478,498843,179,263,95,8,545,10.9253
"61007",38677,625064,438407,165,43,19,0,227,5.17783
"61008",10983,69963,69963,31,5,6,1,43,6.14608
"61010",781,81615,24749,7,0,1,1,9,3.63647
"61011",4530,66041,62237,31,0,1,0,32,5.14163
"61012",3292,40592,40592,27,0,0,0,27,6.65153
"61013",686,53489,11431,6,0,1,0,7,6.12358
"61014",659,7058,7058,5,0,0,0,5,7.08436
"61015",3745,98955,33608,14,0,4,0,18,5.35588
"61017",225,124252,10583,1,0,2,0,3,2.83463
"61018",253,61252,9794,2,0,0,0,2,2.042
"61020",379,10576,10508,3,0,0,0,3,2.85492
"61021",548,12899,4996,4,0,0,0,4,8.00601
"61023",4686,80767,70302,27,0,1,0,28,3.9828
"61024",6826,137960,95259,55,0,2,0,57,5.98366
"61026",812,23661,18937,7,0,0,0,7,3.69648
"61028",4773,211014,77010,24,0,1,0,25,3.24633
"61029",6878,95281,70182,24,2,7,2,35,4.98703
"61030",2955,49013,48272,21,0,1,0,22,4.55755
"61032",2658,63306,50006,17,0,2,0,19,3.79952
"61034",1430,27332,27157,14,0,0,0,14,5.15526
"61035",2533,160920,38439,10,0,0,0,10,2.60155
"61036",607,8133,8133,5,0,0,0,5,6.14809
"61037",500,17698,14670,3,0,0,0,3,2.04497
"61038",18468,150889,102369,18,25,76,6,125,12.2108
"61039",823,9501,9440,6,0,1,0,7,7.4152
"61040",7043,282479,104085,52,1,3,0,56,5.3802
"61041",1130,22225,18887,7,0,0,0,7,3.70621
"61043",4079,60730,60341,25,0,12,0,37,6.13187
"61044",3034,67006,42212,20,0,1,0,21,4.97491
"61046",573,13839,5802,5,0,0,0,5,8.61838
"61048",646,279839,13797,4,0,0,0,4,2.89912
"61049",829,43517,13270,5,0,1,0,6,4.52153
"61050",2210,60617,45849,14,0,0,0,14,3.05349
"61051",2575,146123,52504,20,0,3,0,23,4.38061
"61052",1169,56838,24638,8,0,1,0,9,3.65283
"61053",1200,53810,23484,10,0,1,0,11,4.68409
"61054",1005,49662,42697,12,0,1,0,13,3.04468
"61055",3314,79021,56360,13,3,2,0,18,3.19376
"61056",1045,146671,16550,6,0,1,0,7,4.22963
"61060",1209,23379,17268,9,0,0,0,9,5.21185
"61061",13771,290702,152682,64,3,9,0,76,4.97766
"61063",12018,110806,110806,67,0,6,0,73,6.58807
"61064",423,67228,3952,3,0,0,0,3,7.59206
"61066",629,7841,7841,5,0,0,0,5,6.3771
"61067",2147,56749,43047,12,0,0,0,12,2.78768
"61068",476,11624,11549,6,0,0,0,6,5.19505
"61069",754,11408,11408,3,0,1,0,4,3.50618
"61070",39451,351691,253288,40,3,11,0,54,2.13196
"61071",933,140677,20931,7,0,4,0,11,5.25526
"61072",729,39147,23028,7,0,0,0,7,3.03973
"61074",3432,85765,35878,20,3,10,0,33,9.19773
"61075",14595,346667,171027,72,5,6,0,83,4.85305
"61076",1336,202154,34105,7,0,0,0,7,2.05249
"61077",30493,199818,155766,55,0,28,0,83,5.32849
"61078",6587,135047,91023,35,2,5,0,42,4.6142
"61079",7251,67948,49867,35,2,4,0,41,8.22179
"61080",100,390,387,0,0,1,0,1,25.8065
"61081",11402,320881,147473,71,0,5,0,76,5.1535
"61082",253,3798,3774,3,0,0,0,3,7.94988
"61084",69,2927,2927,1,0,0,0,1,3.41658
"61085",277,11551,11477,2,0,1,0,3,2.61394
"61086",1294,73585,36664,13,0,0,0,13,3.5457
"61087",725,16433,12285,5,0,0,0,5,4.07012
"61089",252,6514,6472,3,0,0,0,3,4.63519
"61091",6745,284417,101005,22,2,5,0,29,2.87114
"61092",5934,75465,73695,43,0,4,1,48,6.51332
"61093",8971,106399,98844,59,0,2,0,61,6.17134
"61094",3308,31597,31597,26,0,0,0,26,8.22869
"61095",6460,94317,82109,41,0,0,0,41,4.99336
"61096",24678,348873,236115,123,4,11,2,140,5.92932
"61097",11995,73539,73539,8,0,8,0,16,2.17571
"61098",5841,78514,57396,39,0,2,0,41,7.14339
"61099",734,11767,9998,4,0,2,0,6,6.00149
"61100",2780,52846,49566,16,0,1,0,17,3.42975
"61101",1910,31899,31694,20,0,0,0,20,6.31026
"61102",6570,84190,77042,32,0,0,1,33,4.28336
"61103",2896,88078,46432,6,0,1,0,7,1.50758
"61104",162,1558,1558,1,0,1,0,2,12.838
"61105",504,6483,6483,4,0,0,0,4,6.16999
"61107",2898,63959,41421,14,0,1,0,15,3.62132
"61108",1331,91942,28342,7,0,2,0,9,3.17546
"61111",1848,30518,30518,13,0,1,0,14,4.58749
"61114",1660,24933,18650,11,0,1,0,12,6.43437
"61116",12364,168677,155666,77,4,5,0,86,5.52465
"61117",53975,551313,236646,171,1,84,0,256,10.8178
"61118",740,12446,12446,6,0,0,0,6,4.8207
"61120",167,5602,5566,2,0,0,0,2,3.59319
"61121",1116,6825,6825,6,0,2,0,8,11.7219
"61122",884,30290,27441,2,0,1,0,3,1.09326
"61123",1491,31792,31588,14,0,0,0,14,4.43205
"61124",3718,85003,62872,26,4,1,0,31,4.93064
"61126",5021,76977,57020,24,0,1,1,26,4.55979
"61129",4845,122256,58920,22,0,3,0,25,4.24303
"61130",3578,274747,50164,23,1,0,0,24,4.78432
"61133",3471,62224,52257,29,0,4,0,33,6.31498
"61137",1111,18695,18695,7,0,0,0,7,3.74428
"61138",3827,122477,60255,10,0,2,0,12,1.99155
"61139",2829,105881,55154,26,0,0,1,27,4.89538
"61140",16002,131979,97906,35,2,2,0,39,3.98343
"61141",4183,58218,39072,29,0,1,0,30,7.67813
"61142",557,62221,15441,2,0,1,0,3,1.94292
"61143",20107,115461,107398,47,6,27,1,81,7.54203
"61145",30688,344681,273152,159,22,20,2,203,7.43177
"61146",3800,46827,34210,29,0,0,0,29,8.47711
"61148",3132,76845,42499,25,1,2,0,28,6.58844
"61149",1500,28865,21249,12,0,0,0,12,5.64744
"61150",6090,79294,69924,18,0,8,0,26,3.7183
"61151",3704,74475,59517,21,0,2,0,23,3.86447
"61152",227,14812,6830,2,0,0,0,2,2.92829
"61153",9670,177334,119378,83,8,7,1,99,8.29299
"61156",2393,169968,51315,32,0,1,0,33,6.4309
"61158",168,1968,1968,0,0,1,0,1,5.08225
"61159",0,753,748,0,0,1,0,1,13.3659
"61160",991,17137,17138,2,0,1,0,3,1.75055
"61162",715,27123,13514,5,0,0,0,5,3.69994
"61163",14213,125935,122245,44,4,11,1,60,4.90819
"61164",2119,33316,30769,14,0,2,0,16,5.2
"61165",6919,182902,83312,49,0,4,0,53,6.36165
"61166",517,9124,9065,5,0,0,0,5,5.51543
"61167",23682,516421,323399,146,25,9,0,180,5.56587
"61168",33066,357704,276570,104,16,26,0,146,5.27895
"61169",107621,747587,565949,265,261,120,5,651,11.5028
"61170",686,29204,14735,6,0,0,0,6,4.07197
"61171",367,4824,4793,2,0,0,0,2,4.1727
"61172",1047,33855,29085,5,0,0,0,5,1.7191
"61173",7335,332597,60886,3,0,6,1,10,1.64242
"61176",790,58180,14106,7,0,0,0,7,4.96244
"61178",238,10136,4364,1,0,0,0,1,2.29158
"61180",152,3620,3001,1,0,0,0,1,3.33263
"61181",12128,64787,64787,51,26,4,1,82,12.6569
"61182",3740,94714,58716,22,4,2,0,28,4.76872
"61187",1005,41615,21813,8,0,0,0,8,3.66762
"61188",81,1496,1486,1,0,0,0,1,6.72764
"61189",2538,64398,50444,19,0,1,0,20,3.96482
"61192",510,12888,10646,4,0,0,0,4,3.75737
"61193",1896,168630,34123,13,0,0,0,13,3.80976
"61194",5686,100815,59014,29,0,2,0,31,5.25296
"61195",1399,31021,13763,7,0,1,0,8,5.81286
"61196",14009,493906,147430,54,1,9,0,64,4.34103
"61197",536,10811,10811,3,0,0,0,3,2.77497
"61198",355,34296,11652,3,0,0,0,3,2.57475
"61199",1703,39180,35027,8,0,1,0,9,2.56944
"61202",7377,264322,102674,37,0,4,0,41,3.99324
"61203",8816,420436,105993,53,2,3,0,58,5.47203
"61206",1156,50072,19301,12,0,0,0,12,6.21716
"61207",6007,54215,54215,18,0,7,0,25,4.61125
"61208",7752,141100,109128,47,0,4,0,51,4.67343
"61209",1260,40804,16393,6,0,3,1,10,6.10013
"61210",1719,51728,48163,15,0,1,1,17,3.52969
"61211",20047,343129,244254,109,0,12,1,122,4.99479
"61212",783,13309,11972,7,0,0,0,7,5.84691
"61213",1649,82913,37945,9,0,0,0,9,2.37186
"61214",49098,331412,275944,172,208,61,0,441,15.9815
"61215",1360,15914,15914,10,0,0,0,10,6.28379
"61216",1830,206676,38690,15,0,0,0,15,3.87694
"61218",12088,103736,94755,55,0,14,0,69,7.2819
"61219",1064,21030,21030,5,0,1,1,7,3.32854
"61221",2150,56252,34226,19,0,0,0,19,5.5514
"61222",10486,128098,114005,33,1,6,1,41,3.59632
"61224",5073,98212,70000,31,0,0,0,31,4.42856
"61225",195,366,364,1,0,0,0,1,27.4988
"61227",1084,64345,20723,8,0,0,0,8,3.86046
"61228",1059,44794,14897,7,0,0,0,7,4.69891
"61229",593,10464,10464,5,0,0,0,5,4.77828
"61230",28144,758195,348102,141,9,27,0,177,5.08471
"61231",831,12431,12431,4,0,1,0,5,4.02233
"61232",9809,132355,113483,53,3,3,0,59,5.19903
"61233",2293,127275,34308,17,0,0,0,17,4.95516
"61234",14485,115386,98909,81,0,6,1,88,8.89704
"61237",1193,47986,22508,10,0,1,0,11,4.88721
"61238",79,877,871,1,0,0,0,1,11.4761
"61240",2072,34029,18880,9,0,1,0,10,5.29672
"61241",2659,47793,38047,26,0,0,0,26,6.83358
"61242",1078,33351,25163,11,0,0,0,11,4.37157
"61243",16535,232838,197220,81,0,4,1,86,4.36061
"61244",896,50327,33111,9,0,0,0,9,2.71817
"61248",7526,59882,45315,21,0,6,0,27,5.95827
"61251",480,14374,14374,3,0,0,0,3,2.08706
"61252",279,6006,6006,2,0,0,0,2,3.33003
"61255",1017,14461,14461,4,3,3,0,10,6.91493
"61256",444,7685,7685,3,0,0,0,3,3.90362
"61257",572,6225,6225,4,0,0,0,4,6.42611
"61258",5122,25190,25190,16,11,6,0,33,13.1004
"61259",191,20697,6576,2,0,0,0,2,3.04137
"61260",5426,134179,98442,43,0,1,0,44,4.46965
"61261",947,101922,12451,4,0,0,0,4,3.2126
"61262",607,24027,13918,7,0,0,0,7,5.0294
"61263",1357,22858,22858,7,0,1,0,8,3.49982
"61264",90,1700,1689,1,0,0,0,1,5.92032
"61265",764,22767,22767,6,0,0,0,6,2.63539
"61266",524,7153,7107,4,0,0,0,4,5.62815
"61267",1588,32275,27834,14,0,0,0,14,5.02981
"61268",918,15990,9170,4,0,0,0,4,4.36223
"61269",4037,56555,56555,27,0,1,0,28,4.95098
"61271",401,19768,8174,4,0,0,0,4,4.89342
"61273",64,11280,2478,1,0,0,0,1,4.03515
"61274",1206,25558,25394,12,0,0,0,12,4.72551
"61275",7180,141603,80200,31,9,20,0,60,7.48132
"61276",280,6561,2640,2,0,0,0,2,7.57587
"61277",2202,154390,39329,14,1,1,0,16,4.06826
"61278",19734,226330,199892,129,1,4,0,134,6.70362
"61279",3885,31451,31451,30,0,0,0,30,9.53863
"61281",1569,43695,36691,13,0,0,0,13,3.54309
"61283",1053,30231,21012,9,0,1,0,10,4.7591
"61284",611,21374,12923,5,0,0,0,5,3.86918
"61285",3452,70407,65678,34,0,0,0,34,5.17677
"61286",339,4486,4486,0,0,1,0,1,2.22929
"61287",4882,65981,62263,26,1,2,0,29,4.65764
"61288",4621,110371,78708,44,0,1,0,45,5.7173
"61289",286,32013,8685,2,0,1,0,3,3.45425
"61290",335,14823,4533,2,0,0,0,2,4.41205
"61291",100,8515,921,0,0,1,0,1,10.8571
"61292",6943,253653,142701,29,3,7,0,39,2.73299
"61293",28803,148406,146778,135,32,28,2,197,13.4217
"61294",6388,75860,62208,52,0,5,1,58,9.32354
"61295",1064,19113,19113,8,0,0,0,8,4.1857
"61297",4762,155653,42221,18,0,3,1,22,5.21072
"61298",1056,21410,15979,9,0,0,0,9,5.63235
"61299",1445,53116,35258,15,0,0,0,15,4.2543
"61300",2020,58499,27296,12,2,2,0,16,5.86165
"61301",1725,68244,24510,11,0,0,1,12,4.8959
"61302",354,21628,9467,3,0,0,0,3,3.16894
"61303",5045,82800,65229,42,0,1,1,44,6.74545
"61304",3349,70858,45664,22,0,0,0,22,4.81782
"61307",930,26230,22205,7,0,0,0,7,3.15248
"61308",465,5459,5459,3,0,0,0,3,5.49562
"61309",11139,304102,229273,112,0,6,1,119,5.19032
"61310",3209,60690,37481,19,0,2,0,21,5.60288
"61311",416,27703,5840,4,0,0,0,4,6.84896
"61314",5487,230347,56109,30,0,1,0,31,5.52496
"61316",764,84366,13121,6,0,1,0,7,5.33483
"61317",781,49956,12085,4,0,0,0,4,3.3099
"61319",676,14012,13922,6,0,0,0,6,4.30968
"61321",2210,21209,21209,18,0,0,0,18,8.48699
"61322",738,13972,13972,6,0,0,0,6,4.29432
"61323",779,29196,16688,8,0,0,0,8,4.79378
"61324",7789,120349,79962,41,7,5,0,53,6.62811
"61326",1265,11358,11358,10,0,4,0,14,12.3262
"61327",1874,49466,13588,2,3,0,0,5,3.6798
"61328",403,31624,10940,4,0,3,0,7,6.39832
"61329",7310,275889,66046,45,0,2,0,47,7.11621
"61330",166,8024,2980,1,0,0,0,1,3.35606
"61331",723,29750,18190,7,0,0,0,7,3.84835
"61332",1645,31147,31147,10,0,1,1,12,3.85272
"61333",271,5829,5792,1,0,0,1,2,3.45327
"61336",1953,44270,17605,1,0,3,0,4,2.27208
"61339",18042,329415,230836,84,2,8,0,94,4.07216
"61341",19613,239332,195070,78,0,7,1,86,4.40867
"61342",6012,80660,52999,47,0,0,0,47,8.86813
"61344",7862,72525,69742,54,6,3,0,63,9.03332
"61345",14603,194770,170633,70,1,12,0,83,4.86424
"61346",575,56920,16456,6,0,0,0,6,3.6462
"61347",494,15101,15101,4,0,0,0,4,2.64885
"61348",2405,55390,34962,15,0,0,0,15,4.29037
"61349",474,9716,5788,3,0,0,0,3,5.18295
"61350",792,10011,9222,3,0,0,0,3,3.2531
"61351",1436,156961,35205,11,0,0,0,11,3.12456
"61352",1174,35367,10150,0,0,1,0,1,0.985245
"61357",271,46137,3494,4,0,0,0,4,11.4467
"61358",1086,26297,12850,6,0,0,0,6,4.66915
"61360",43,26080,2136,0,0,0,0,0,0
"61361",1030,37209,31187,6,0,0,0,6,1.9239
"61362",7034,103563,86676,27,1,3,0,31,3.57654
"61363",472,13298,8609,3,0,0,0,3,3.4847
"61365",3049,124248,34655,18,0,2,0,20,5.77116
"61366",105,22013,6367,2,0,0,0,2,3.14135
"61367",326,2985,2985,1,0,1,1,3,10.0498
"61369",10835,365109,140941,68,6,3,1,78,5.53425
"61370",1344,36923,26995,5,1,1,0,7,2.59304
"61371",179,2957,2938,2,0,0,0,2,6.80727
"61372",72,73,73,1,0,0,0,1,136.987
"61373",1839,39016,26703,12,0,1,0,13,4.86831
"61374",321,7874,7824,3,0,0,0,3,3.8346
"61375",10047,231964,129131,67,0,1,0,68,5.26598
"61376",7782,122427,119208,47,2,1,0,50,4.19433
"61379",587,18799,16879,5,0,2,0,7,4.14715
"61382",6451,80167,65246,38,6,2,0,46,7.05022
"61383",513,8277,8277,3,0,0,0,3,3.62452
"61384",843,106276,21165,6,0,0,0,6,2.83493
"61385",4038,199340,74426,28,0,0,0,28,3.76212
"61386",3103,176655,40605,27,0,0,1,28,6.89564
"61387",4594,76531,34994,21,0,4,0,25,7.14404
"61388",683,12519,12519,3,0,0,0,3,2.39634
"61389",3445,197552,33257,17,0,1,1,19,5.71314
"61390",348,3898,3898,3,0,0,0,3,7.69652
"61391",28798,270160,177283,155,87,11,0,253,14.271
"61392",534,22677,17037,5,0,0,0,5,2.93478
"61393",727,28419,16780,5,0,0,0,5,2.97966
"61394",2881,66825,54888,19,0,2,0,21,3.82595
"61395",874,37549,29815,7,0,0,0,7,2.34778
"61396",1287,4328,4328,1,0,2,0,3,6.93094
"61397",32666,296444,276800,196,37,25,0,258,9.32079
"61399",111,6000,3348,1,0,0,0,1,2.98651
"61400",2783,51912,24752,22,0,2,1,25,10.1004
"61401",1567,49682,31824,8,0,0,0,8,2.51385
"61402",2069,76894,40541,11,0,1,0,12,2.95994
"61403",1764,83757,25506,10,0,0,0,10,3.92061
"61404",11897,94764,80402,47,0,11,0,58,7.21372
"61405",1759,25950,17789,13,0,1,0,14,7.87009
"61406",1073,17450,17450,7,0,0,0,7,4.01145
"61407",4777,70585,70585,31,0,3,0,34,4.8169
"61408",1584,38440,31691,11,0,0,0,11,3.47097
"61411",1194,38660,23549,7,0,1,0,8,3.39714
"61412",4846,62974,58751,19,9,6,0,34,5.78713
"61413",206,3770,3746,2,0,0,0,2,5.33928
"61414",18569,162453,162453,44,5,12,0,61,3.75493
"61415",4326,176035,68127,18,0,3,1,22,3.22925
"61418",1504,32202,19532,10,0,0,0,10,5.11968
"61419",1057,13677,12068,6,0,0,0,6,4.97178
"61420",242,5242,5208,2,0,0,0,2,3.83996
"61421",4523,359974,64150,24,0,1,1,26,4.05303
"61422",7637,192934,87558,30,4,5,2,41,4.6826
"61423",6047,87363,72678,47,2,0,0,49,6.74211
"61424",1647,167021,22904,13,0,2,0,15,6.54903
"61425",612,13182,8660,3,0,0,0,3,3.46418
"61426",2300,31609,31609,11,0,1,0,12,3.79643
"61427",417,75414,8845,5,0,0,0,5,5.65297
"61429",4254,88522,45780,30,6,1,0,37,8.08206
"61432",1220,41055,30428,8,0,1,0,9,2.95784
"61433",1549,52912,29570,10,0,0,0,10,3.38177
"61435",2137,117906,53986,13,0,0,0,13,2.40801
"61436",1479,36906,36906,13,0,0,0,13,3.52247
"61438",997,162559,24733,6,0,1,0,7,2.83026
"61439",1033,15797,15797,0,0,1,0,1,0.633014
"61440",24983,164108,141086,51,0,14,0,65,4.60713
"61442",1545,27502,27502,10,0,0,0,10,3.63615
"61443",6233,99307,87926,38,4,9,0,51,5.80031
"61444",1649,48467,30541,4,0,2,0,6,1.96457
"61445",3262,62239,49062,31,0,1,0,32,6.52232
"61446",402,114022,6644,3,0,0,0,3,4.51512
"61447",15409,160598,135455,68,76,12,0,156,11.5168
"61448",2827,61347,55817,23,0,1,0,24,4.29979
"61450",1002,231116,16874,3,0,0,0,3,1.77791
"61451",3234,115555,63213,27,0,0,0,27,4.27124
"61452",1696,121916,28725,9,0,0,0,9,3.13311
"61453",838,19177,12358,6,0,2,0,8,6.47342
"61454",3160,95112,46460,17,0,4,0,21,4.51997
"61456",46552,299201,273805,102,7,29,1,139,5.0766
"61457",23905,147868,127229,29,2,4,1,36,2.82954
"61459",3794,139882,63564,18,0,3,0,21,3.30375
"61460",3751,113822,68552,25,11,10,0,46,6.71028
"61461",1013,104273,12516,2,0,2,1,5,3.99497
"61462",38682,294596,271503,68,0,8,1,77,2.83607
"61463",22773,525091,253840,138,0,8,2,148,5.83044
"61464",33796,449593,228101,72,138,40,5,255,11.1792
"61466",13196,105493,102908,92,1,2,0,95,9.23157
"61467",2808,117693,46978,15,0,2,0,17,3.61872
"61468",741,13248,7353,3,0,1,0,4,5.43987
"61472",1477,17742,17742,8,0,1,0,9,5.07261
"61473",1978,33180,32967,19,0,2,0,21,6.36997
"61474",20595,541028,321637,169,0,7,1,177,5.50309
"61475",4752,130147,63549,35,0,1,0,36,5.66496
"61476",1688,28615,25649,14,0,0,0,14,5.45831
"61479",562,13911,11194,4,0,1,0,5,4.46678
"61480",1606,34363,34363,7,0,2,0,9,2.6191
"61481",245,4500,4471,2,0,0,0,2,4.47313
"61482",4244,50994,50994,31,0,0,0,31,6.07909
"61483",17754,366620,188420,77,99,13,0,189,10.0308
"61484",36852,435034,227944,90,2,11,1,104,4.56253
"61485",847,30026,21646,9,0,0,0,9,4.15776
"61486",21549,485898,389625,158,12,17,1,188,4.82515
"61487",2613,44358,35845,15,0,1,0,16,4.46367
"61488",246,3235,3235,2,0,0,0,2,6.18331
"61490",1459,29033,28847,11,0,1,1,13,4.50656
"61491",13960,336093,229207,150,18,10,0,178,7.76592
"61492",460,27778,11663,3,0,1,0,4,3.42973
"61493",2826,415063,50371,1,0,13,0,14,2.77938
"61494",9172,44732,44732,40,0,4,0,44,9.83642
"61497",30523,414840,193375,83,22,34,0,139,7.18809
"61498",507,3156,3156,3,0,0,0,3,9.50689
"61499",986,123133,11319,7,0,0,0,7,6.18441
"61500",91,3119,3099,1,0,0,0,1,3.22685
"61501",749,15219,15121,7,0,0,0,7,4.6292
"61502",391,12783,6173,2,0,0,0,2,3.23972
"61503",391,97504,13179,4,0,1,0,5,3.79393
"61505",741,17441,10192,4,0,1,0,5,4.90571
"61507",2097,40159,31043,15,0,0,0,15,4.83197
"61508",16889,208404,132413,54,36,13,0,103,7.77869
"61510",3127,53407,40810,16,0,1,0,17,4.16566
"61512",526,7745,7745,0,0,2,0,2,2.58243
"76001",11409,124437,105308,97,2,3,0,102,9.68592
"76002",4798,124483,122249,50,0,4,0,54,4.41723
"76004",3496,41426,41426,21,1,2,0,24,5.79341
"76005",14758,87563,84006,106,172,5,1,284,33.8071
"76006",1494,20800,20800,13,0,0,0,13,6.24992
"76007",3375,37075,37075,22,0,0,0,22,5.93394
"76008",3767,30646,30646,29,0,4,0,33,10.768
"76009",2518,31947,31947,23,0,0,0,23,7.19936
"76010",2523,35299,35299,21,0,0,0,21,5.94914
"76011",1197,17545,17545,8,0,1,1,10,5.69967
"76012",1036,18253,18253,6,0,0,0,6,3.28715
"76013",10235,145278,138527,67,7,1,0,75,5.41412
"76014",9186,104519,92701,52,4,4,0,60,6.47244
"76015",3421,59051,39284,22,0,0,0,22,5.60024
"76016",717,13123,13123,6,0,0,0,6,4.57203
"76017",6344,89194,81549,22,0,2,0,24,2.943
"76018",10869,158467,151614,78,1,6,0,85,5.60635
"76019",2641,54077,39687,18,0,1,0,19,4.78749
"76020",11528,155747,103242,86,0,4,0,90,8.71737
"76021",5345,62914,62914,47,0,0,0,47,7.47052
"76022",755,19802,11972,4,0,0,0,4,3.34111
"76023",1746,32038,32038,16,0,0,0,16,4.99409
"76024",864,15668,15668,6,0,0,0,6,3.82944
"76025",1787,9853,9853,8,0,1,0,9,9.13472
"76026",42272,186230,167985,32,46,18,3,99,5.89338
"76028",1488,28044,26128,10,0,0,0,10,3.82724
"76029",714,13844,11333,6,0,0,0,6,5.29449
"76030",4019,46877,46878,27,0,2,0,29,6.18633
"76032",1746,36249,22562,10,0,0,0,10,4.43215
"76033",3680,44556,44556,32,0,0,0,32,7.18203
"76034",17189,147114,147114,98,21,14,0,133,9.0406
"76035",13354,61494,61494,12,16,10,1,39,6.34208
"76036",5393,67284,67284,43,0,2,0,45,6.68803
"76038",3076,51101,41368,23,0,0,0,23,5.55982
"76039",8814,88146,62357,44,0,1,0,45,7.21645
"76040",1348,24225,24225,11,0,1,0,12,4.95356
"76041",4033,56941,56941,25,0,3,0,28,4.91736
"76042",248,3702,3702,2,0,0,0,2,5.4027
"76043",8968,127186,83407,80,0,2,0,82,9.83131
"76045",2917,80499,60555,26,5,0,0,31,5.11932
"76046",4137,47659,47659,37,0,0,0,37,7.76352
"76047",1197,12621,12621,4,0,0,0,4,3.16928
"76048",1438,31980,22023,8,0,0,0,8,3.63262
"76049",1042,14969,14969,9,0,0,0,9,6.0123
"76050",6887,97712,88321,69,0,2,0,71,8.03883
"76051",8282,93657,82899,45,9,7,0,61,7.35836
"76052",1517,17625,17625,11,0,0,0,11,6.24117
"76053",224,3021,3021,2,0,0,0,2,6.62128
"76054",1246,204311,18639,11,0,0,0,11,5.90149
"76055",1319,16662,16662,13,0,0,0,13,7.8021
"76056",4198,87099,49127,39,1,0,0,40,8.14213
"76057",118912,558093,547212,268,131,54,0,453,8.27833
"76058",999,10624,10624,9,0,0,0,9,8.47156
"76059",4781,62974,56353,31,0,0,0,31,5.50104
"76060",3708,56131,56131,31,0,0,0,31,5.52283
"76062",2020,37496,35512,15,0,0,0,15,4.22391
"76063",4295,67284,65663,35,0,0,0,35,5.33028
"76064",5320,48497,48497,36,0,0,0,36,7.42317
"76065",2265,29816,29816,23,0,0,0,23,7.71386
"76066",2131,12440,12439,8,0,1,0,9,7.23504
"76067",5114,81928,81928,39,9,0,0,48,5.8588
"76068",3964,83451,48136,32,0,0,0,32,6.64778
"76069",16329,124185,88783,81,6,3,0,90,10.1371
"76070",1619,28463,28463,14,0,2,0,16,5.6214
"76071",1848,30546,30546,15,0,0,0,15,4.9106
"76072",12830,208227,150251,89,0,3,0,92,6.12309
"76075",1852,22010,22010,16,0,0,0,16,7.26942
"76076",2770,40469,28873,15,0,0,0,15,5.19516
"76077",1260,40869,27524,10,0,0,0,10,3.63321
"76079",1728,17278,17278,18,0,0,0,18,10.4177
"76082",6512,132423,84491,37,0,1,0,38,4.49751
"76083",314,5918,5918,3,0,0,0,3,5.06929
"76084",707,8573,8573,9,0,0,0,9,10.498
"76085",1461,35021,35021,12,0,0,0,12,3.42653
"76086",3033,46670,40503,15,0,0,0,15,3.70339
"76087",2710,47709,47709,28,0,1,0,29,6.07847
"76088",3859,45276,41790,17,0,1,0,18,4.3073
"76090",6416,71054,71053,49,0,1,0,50,7.03696
"76091",2421,34018,34018,19,0,0,0,19,5.58531
"76092",3247,26584,26584,24,0,0,0,24,9.0279
"76093",2936,72426,48697,28,0,0,0,28,5.74988
"76094",1361,31208,26082,10,0,0,0,10,3.83412
"76095",17375,101570,82739,50,49,11,0,110,13.2948
"76096",7461,119687,94743,47,0,1,0,48,5.06634
"76097",932,28160,9831,5,0,1,0,6,6.10315
"76099",3611,63990,54543,21,0,3,0,24,4.40018
"76100",8315,140584,107914,54,1,1,1,57,5.28199
"76101",17518,113896,113895,103,25,11,0,139,12.2042
"76103",8471,36452,36452,27,110,4,1,142,38.955
"76104",982,11778,11778,7,0,0,0,7,5.9435
"76105",14427,98263,77159,20,0,1,0,21,2.72164
"76106",3801,49338,49338,28,0,0,0,28,5.67519
"76107",4835,81343,70199,32,1,2,0,35,4.98583
"76108",78609,516056,447798,253,307,74,1,635,14.1805
"76109",1783,67153,64799,9,1,2,0,12,1.85189
"76110",2589,38537,38538,31,0,0,0,31,8.0441
"76111",2428,26794,26794,20,0,0,0,20,7.46445
"76112",2330,49341,30030,19,0,1,0,20,6.66001
"76113",3260,39318,39318,29,0,0,0,29,7.37573
"76114",32644,255345,188192,99,179,31,1,310,16.4725
"76115",5468,70940,55267,35,0,0,0,35,6.33288
"76116",35091,231370,215948,268,0,11,0,279,12.9198
"76117",8419,204263,108344,52,0,1,0,53,4.89181
"76118",894,12835,12835,3,0,0,0,3,2.33739
"76119",644,19404,8927,4,0,0,0,4,4.4809
"76120",1826,55090,28863,13,0,0,0,13,4.50405
"76121",2110,35074,27223,19,0,0,0,19,6.97936
"76122",5523,90661,79599,24,3,5,0,32,4.02014
"76123",9955,149893,98632,60,0,0,0,60,6.08323
"76124",3243,57374,57374,25,0,0,0,25,4.35736
"76125",7026,60238,60238,34,12,5,0,51,8.46645
"76126",2421,35537,26568,19,0,0,0,19,7.1514
"76128",2933,61518,50393,22,0,1,0,23,4.56409
"76129",978,15028,11412,10,0,0,0,10,8.76248
"76130",3180,29215,29215,14,0,1,0,15,5.13437
"76131",782,6556,6556,3,16,0,0,19,28.9832
"76132",3039,41126,41126,30,0,0,0,30,7.29471
"76133",1906,41985,38065,12,0,1,0,13,3.4152
"76134",768,13279,13279,13,0,0,0,13,9.78955
"76135",5108,63950,59134,34,3,1,0,38,6.42609
"76136",10492,73743,70499,57,0,5,0,62,8.7944
"76138",7501,156301,74379,14,0,3,0,17,2.28558
"76139",2387,47227,45347,16,0,0,0,16,3.52836
"76140",1118,16445,16445,7,0,0,0,7,4.2565
"76141",15123,228191,122971,86,0,7,0,93,7.56278
"76142",3285,72349,49801,22,0,0,0,22,4.4176
"76143",11194,112261,112261,61,2,13,0,76,6.76994
"76144",1090,36296,23522,6,0,0,0,6,2.55078
"76146",20246,174996,152633,93,58,17,1,169,11.0723
"76147",5951,128326,80789,39,0,3,0,42,5.19875
"76148",1359,15867,15867,12,0,0,0,12,7.56273
"76149",1662,23737,23737,12,0,0,0,12,5.05536
"76151",1873,38684,34960,14,0,0,0,14,4.0046
"76152",2840,45878,28434,19,8,1,0,28,9.84741
"76153",1350,23670,23670,16,0,0,0,16,6.7595
"76154",629,9734,9734,7,0,0,0,7,7.1914
"76155",2076,25463,25463,17,0,0,0,17,6.67628
"76156",3307,31606,31605,23,0,0,0,23,7.27723
"76157",75775,309600,272525,223,680,34,1,938,34.4189
"76158",3611,66019,54371,26,0,1,0,27,4.96587
"76159",8076,61014,61014,43,74,6,0,123,20.1592
"76160",4860,72243,68216,39,0,0,0,39,5.71716
"76161",244,3911,3911,2,0,0,0,2,5.11363
"76162",2115,70353,44059,19,0,0,0,19,4.31244
"76163",2149,42918,27298,10,5,0,0,15,5.49489
"76164",20996,233746,216549,65,79,21,0,165,7.61954
"76165",46671,251518,219885,206,283,18,1,508,23.103
"76166",3482,43904,43905,30,0,0,0,30,6.83301
"76167",16000,137130,130133,81,0,3,0,84,6.45496
"76168",590,8315,8315,5,0,0,0,5,6.01356
"76169",8626,114836,107009,67,0,0,0,67,6.26114
"76170",1737,42002,28936,11,0,0,0,11,3.80155
"76171",1949,41533,41533,13,0,0,0,13,3.13007
"76172",692,15862,15862,5,0,0,0,5,3.15217
"76173",5216,117413,67897,46,0,0,0,46,6.77492
"76174",1771,39407,36528,18,0,1,0,19,5.20146
"76175",1446,22629,22629,12,0,2,0,14,6.1867
"76176",3020,31087,31087,29,0,1,0,30,9.65042
"76177",1436,17211,17211,12,0,0,0,12,6.97218
"76178",18847,87531,85390,87,46,24,0,157,18.3861
"76179",8385,144956,90476,39,40,1,0,80,8.8421
"76180",2257,35459,35459,17,0,0,0,17,4.79431
"76181",2863,40774,40774,4,0,1,0,5,1.22627
"76182",3139,35469,35469,11,0,1,0,12,3.38319
"76183",5994,84013,69611,37,3,7,0,47,6.75181
"76184",121,1702,1702,1,0,1,0,2,11.7526
"76185",547,7066,7066,5,0,0,0,5,7.07611
"76186",7017,97969,82120,29,0,6,0,35,4.26206
"76187",316,2824,2824,2,0,0,0,2,7.08332
"76188",3172,43679,43679,32,0,1,0,33,7.55514
"76189",2012,17319,17319,11,0,0,0,11,6.35134
"76190",503,6603,6603,4,0,0,0,4,6.05744
"76191",3762,73695,56677,26,0,0,0,26,4.58743
"76192",26720,224339,220761,186,190,13,0,389,17.6209
"76193",2450,56772,42074,20,0,0,0,20,4.75356
"76194",378,3222,3222,4,0,0,0,4,12.4162
"76195",1511,25968,25968,16,0,0,0,16,6.16137
"76196",25648,206280,178251,107,85,11,1,204,11.4445
"76197",2656,65252,65252,22,1,7,0,30,4.59757
"76198",6871,112372,112372,53,0,3,0,56,4.98343
"76199",6258,117775,83969,41,0,1,0,42,5.00185
"76200",1901,19617,19617,17,0,0,0,17,8.66592
"76201",2471,50099,24867,22,12,0,0,34,13.6728
"76202",3182,43720,43720,31,0,0,0,31,7.09056
"76203",3648,41511,41511,36,0,0,0,36,8.67241
"76204",1761,30466,29385,18,0,0,0,18,6.12557
"76205",10135,49963,49963,7,0,7,0,14,2.80209
"76206",2571,47279,41633,19,0,0,0,19,4.56371
"76207",853,20536,13749,7,0,0,0,7,5.09111
"76208",7405,151769,102941,48,6,0,0,54,5.24572
"76209",4045,80575,60665,33,0,1,0,34,5.60452
"76210",2586,22118,22118,19,0,0,0,19,8.59043
"76211",1199,31530,19899,6,0,1,0,7,3.51775
"76212",40068,159576,159576,101,389,21,0,511,32.0224
"76213",1759,18478,18478,12,0,0,0,12,6.49405
"76214",1854,25940,25940,16,0,0,0,16,6.16803
"76216",25559,79196,74366,38,466,19,3,526,70.7315
"76217",75596,371057,329144,238,845,74,3,1160,35.243
"76218",255,2205,2205,1,0,0,0,1,4.5342
"76219",16016,236158,182353,80,46,11,0,137,7.5129
"76220",3104,53643,53079,26,0,0,0,26,4.89834
"76221",2694,62144,51496,18,0,0,0,18,3.49544
"76222",19178,155419,146197,121,78,9,0,208,14.2274
"76223",3416,37547,35132,31,0,0,0,31,8.82374
"76224",6532,114273,69117,34,0,2,0,36,5.20856
"76225",1321,16055,16055,8,0,1,0,9,5.60563
"76226",2259,28151,28151,18,0,0,0,18,6.39417
"76227",5738,88954,88954,45,0,3,0,48,5.39605
"76228",1731,16355,16355,14,0,0,0,14,8.5602
"76229",2554,37217,37217,21,0,0,0,21,5.64253
"76230",4537,74718,69332,33,6,0,0,39,5.62515
"76231",49858,207951,194936,242,818,20,0,1080,55.4027
"76232",3570,40117,40117,38,6,1,0,45,11.2171
"76233",794,20261,13565,7,0,0,0,7,5.16046
"76234",2494,42544,39956,23,0,0,0,23,5.75633
"76235",9689,114439,101563,60,29,5,0,94,9.25536
"76236",822,18047,18047,9,0,0,0,9,4.98688
"76237",3184,30587,29725,24,0,0,0,24,8.07405
"76238",14220,147696,118205,40,2,18,0,60,5.07595
"76239",4772,369213,49484,22,0,2,0,24,4.8501
"76240",24458,205041,205041,61,0,8,0,69,3.36518
"76241",368,7409,7409,2,0,0,0,2,2.69943
"76242",670,17750,17750,5,0,0,0,5,2.8169
"76243",2929,41860,41860,25,0,1,0,26,6.21113
"76244",3263,56726,42605,27,0,1,0,28,6.57203
"76245",17984,139634,125341,69,1,21,0,91,7.26018
"76247",4699,114409,50171,30,0,2,0,32,6.37817
"76249",8213,103770,103036,76,0,2,0,78,7.57014
"76250",5982,140041,89107,38,3,0,0,41,4.60122
"76251",2180,62348,39779,16,0,0,0,16,4.02221
"76252",12498,98104,98104,43,2,13,0,58,5.91209
"76253",7780,133984,103320,59,12,1,0,72,6.96867
"76254",1743,37435,19250,7,3,1,0,11,5.71433
"76255",42483,243464,197640,114,98,34,0,246,12.4469
"76257",1126,19736,19736,11,0,0,0,11,5.5735
"76258",32091,422462,334063,183,102,9,0,294,8.80074
"76259",81072,384634,357163,184,610,94,4,892,24.9746
"76260",11435,81583,81583,52,11,9,1,73,8.9479
"76261",3423,99493,62978,27,1,0,0,28,4.446
"76262",701,17860,17860,5,0,0,0,5,2.79958
"76263",8651,176757,126332,54,0,6,0,60,4.74938
"76264",2366,24966,24966,15,0,1,0,16,6.40874
"76265",513,16368,9750,3,0,0,0,3,3.07684
"76266",9378,60525,46784,56,0,3,0,59,12.6112
"76268",627,13857,13857,4,0,0,0,4,2.88657
"76269",1394,16017,16017,12,0,0,0,12,7.49226
"76270",11130,101600,101600,70,3,0,0,73,7.18504
"76271",8594,83253,83253,86,0,1,0,87,10.4501
"76272",1321,12761,12761,12,0,0,0,12,9.40393
"76273",1803,16994,16994,13,0,0,0,13,7.64972
"76274",195,1619,1619,1,0,0,0,1,6.17691
"76275",3542,33830,28461,21,0,0,0,21,7.37848
"76276",25144,271107,237151,88,128,21,1,238,10.0358
"76278",3699,41889,34850,7,10,8,0,25,7.1736
"76279",1881,40775,40775,10,0,4,0,14,3.43344
"76280",327,7500,6363,3,0,0,0,3,4.71477
"76281",21923,200605,186071,138,20,7,0,165,8.86759
"76282",1681,30307,26396,15,0,0,0,15,5.68258
"76283",2685,111880,42667,19,0,1,0,20,4.68747
"76284",3143,37077,37077,26,0,0,0,26,7.01251
"76285",5588,62159,62159,41,0,0,0,41,6.59602
"76286",6733,217216,75311,35,0,2,0,37,4.91297
"76287",5859,69358,69358,43,0,0,0,43,6.19968
"76288",2229,47342,33326,21,0,0,0,21,6.3014
"76289",11701,159768,151752,102,4,8,1,115,7.57814
"76290",2604,47148,47148,17,0,1,0,18,3.8178
"76291",5105,49512,49512,33,5,3,0,41,8.28086
"76292",1251,18325,18325,9,0,1,0,10,5.45701
"76293",1385,22984,22984,12,0,0,0,12,5.22092
"76294",1339,29164,29164,12,0,1,0,13,4.45762
"76295",6027,65761,46169,33,3,9,0,45,9.7467
"76296",24044,161139,159682,146,0,11,0,157,9.83206
"76297",1114,17675,17676,10,0,0,0,10,5.65755
"76298",2768,34138,34138,25,0,1,0,26,7.61626
"76299",3821,51823,48957,32,0,1,0,33,6.74065
"76300",4035,29532,29532,17,0,1,0,18,6.09505
"76302",16582,118947,118947,72,133,8,0,213,17.9071
"76303",4482,43740,43740,25,0,2,0,27,6.17278
"76304",3230,85876,52479,17,0,0,0,17,3.23939
"76305",166067,2311540,1044421,144,141,81,14,380,3.63838
"76306",1222,17969,17969,12,0,0,0,12,6.67822
"76307",5302,59257,56121,21,31,4,0,56,9.97848
"76308",5661,91707,91707,44,0,0,0,44,4.79787
"76309",230,2268,2268,2,0,0,0,2,8.81779
"76311",925,29425,14191,8,0,0,0,8,5.63734
"76312",39174,269188,269188,224,121,26,0,371,13.7822
"76313",4754,50446,50446,29,11,0,0,40,7.92934
"76314",4827,60352,60352,34,0,0,0,34,5.63363
"76315",6455,81247,68011,50,7,0,0,57,8.38105
"76316",1179,111959,13110,10,0,0,0,10,7.62794
"76317",2361,69910,69910,18,0,2,0,20,2.86084
"76318",2954,57175,38174,18,0,0,0,18,4.71529
"76319",90361,462333,428529,297,54,41,0,392,9.14757
"76320",1969,28906,25874,18,9,0,0,27,10.4351
"76321",7904,114224,84727,39,5,8,0,52,6.13738
"76322",200151,766402,688755,163,407,81,2,653,9.48088
"76323",1295,22831,22831,13,0,0,0,13,5.6939
"76324",5702,33384,33384,36,0,3,0,39,11.6822
"76325",2222,39751,37782,14,0,1,0,15,3.97015
"76327",2914,30498,30498,22,0,0,0,22,7.21365
"76328",3047,117856,75714,22,0,3,0,25,3.30188
"76329",41738,224030,205205,203,57,22,0,282,13.7424
"76330",5883,79015,72567,33,0,2,0,35,4.82313
"76331",2758,37121,30862,28,0,0,0,28,9.07272
"76332",4407,37492,37492,42,0,0,0,42,11.2024
"76333",3324,32258,32258,25,2,1,0,28,8.67994
"76334",3057,44313,35699,18,2,4,1,25,7.00306
"76335",830,5727,5727,6,0,0,0,6,10.4774
"76336",3170,51580,51580,24,0,0,0,24,4.65295
"76338",1137,19890,16355,14,0,1,0,15,9.17143
"76339",1794,20202,15754,19,0,0,0,19,12.0604
"76340",3605,57093,47290,28,0,0,0,28,5.92094
"76341",40112,239922,193931,66,140,45,1,252,12.9943
"76342",4321,65085,55103,35,0,0,0,35,6.35176
"76343",1600,15877,15877,10,0,0,0,10,6.29846
"76344",2059,34319,32155,18,0,0,0,18,5.59789
"76345",1758,23037,23037,10,0,1,0,11,4.77496
"76346",2393,43578,37575,16,5,0,0,21,5.5888
"76347",3018,50525,50525,19,0,0,0,19,3.76052
"76348",4249,48693,48693,36,0,1,0,37,7.59864
"76349",9077,109750,94913,51,8,6,0,65,6.84837
"76350",2514,24142,22522,18,0,0,0,18,7.99229
"76351",573108,3494853,2078682,952,5315,808,45,7120,34.2525
"76352",2262,26443,25388,17,0,1,0,18,7.08997
"76354",5486,56378,54741,39,0,0,0,39,7.12441
"76355",3351,94215,45484,27,2,1,0,30,6.59577
"76356",812,8114,8114,7,0,0,0,7,8.62739
"76357",1727,31781,23072,6,3,0,0,9,3.90081
"76358",1431,22832,22832,10,0,1,0,11,4.8178
"76359",1289,21821,21821,10,2,1,0,13,5.95766
"76360",4207,109426,69893,30,0,0,0,30,4.29228
"76361",4462,75750,50913,27,1,2,0,30,5.8924
"76362",2830,54448,54448,24,0,0,0,24,4.40786
"76363",3107,43357,43357,27,0,1,0,28,6.45806
"76364",3205,85524,48466,29,0,0,0,29,5.98363
"76365",1146,7024,7024,13,0,0,0,13,18.5068
"76366",16426,68887,67215,15,81,8,1,105,15.6216
"76367",19837,151874,150717,145,4,1,0,150,9.95244
"76368",3147,42979,37539,19,4,0,0,23,6.12695
"76369",3420,90826,66340,21,0,3,0,24,3.61774
"76370",3706,41070,41070,28,0,1,0,29,7.06117
"76371",468,5199,5199,4,0,0,0,4,7.69405
"76372",3952,44040,41748,26,0,2,0,28,6.70696
"76373",1667,23790,23790,10,1,1,0,12,5.04416
"76374",1256,13795,13795,14,0,0,0,14,10.1488
"76375",1895,34239,24158,12,0,0,0,12,4.96738
"76377",46551,307609,295857,181,13,61,2,257,8.68663
"76378",8730,142426,109192,52,4,5,0,61,5.58648
"76379",996,10567,10567,7,0,0,0,7,6.62418
"76380",1828,33848,24280,13,0,0,0,13,5.35429
"76381",755,19727,19727,5,0,0,0,5,2.53465
"76382",7386,81861,65970,48,0,3,0,51,7.73078
"76383",877,12836,12836,9,0,0,0,9,7.01174
"76384",55316,247273,239647,39,113,36,3,191,7.97004
"76385",6563,85038,69062,57,0,1,0,58,8.39823
"76386",1741,33992,29185,12,0,0,0,12,4.11174
"76387",2264,25030,25031,21,0,1,0,22,8.78927
"76388",5809,74358,58416,19,0,1,0,20,3.42375
"76389",429,5926,5926,4,0,0,0,4,6.75008
"76390",6186,124800,68994,39,2,4,0,45,6.52231
"76391",22404,235307,178502,146,4,5,1,156,8.7394
"76392",11445,95379,95379,88,13,3,0,104,10.9039
"76394",5284,36438,36438,23,0,3,0,26,7.13542
"76395",3674,74596,57481,38,0,0,0,38,6.61094
"76396",1170,29401,24083,7,15,0,0,22,9.13504
"76397",7065,47938,47938,65,0,2,0,67,13.9764
"76398",1833,34269,27775,15,0,0,0,15,5.4005
"76399",680,12995,12995,5,0,0,0,5,3.8476
"76400",11658,100990,100990,57,3,11,0,71,7.03041
"76401",14823,235575,189219,120,1,4,0,125,6.60612
"76402",24052,178632,162724,157,61,2,0,220,13.5198
"76403",1114,10008,10008,4,4,0,0,8,7.99375
"76404",9355,118077,92961,61,0,2,0,63,6.77702
"76405",1844,94213,24962,14,0,0,0,14,5.60849
"76406",6490,75655,73883,39,64,0,0,103,13.941
"76407",1954,23023,23023,12,0,1,0,13,5.64644
"76408",5212,75146,74702,51,0,2,0,53,7.09484
"76409",5900,143544,50956,44,0,1,0,45,8.83122
"76410",17650,60210,54542,28,98,18,0,144,26.4019
"76411",2034,46387,46387,6,0,4,0,10,2.15576
"76412",5293,54752,54752,40,0,2,0,42,7.67102
"76413",563,5406,5405,5,0,0,0,5,9.2499
"76414",17173,121895,121314,92,43,16,0,151,12.447
"76415",3104,65384,47818,18,0,2,0,20,4.18252
"76416",5924,71253,71253,34,0,1,1,36,5.05239
"76417",3257,42741,42741,24,0,2,0,26,6.0832
"76418",6792,71305,71305,52,0,3,0,55,7.71333
"76419",610,13562,11568,4,0,0,0,4,3.45795
"76420",10923,434632,110635,20,0,3,0,23,2.07891
"76421",2829,74448,41095,18,2,2,0,22,5.35345
"76422",1384,14256,11860,13,0,0,0,13,10.9613
"76424",2066,22864,22864,19,0,0,0,19,8.31001
"76425",3613,41659,41659,22,0,0,0,22,5.28101
"76426",1677,74617,35399,13,0,1,0,14,3.95488
"76427",8549,176193,92958,57,2,1,1,61,6.56208
"76428",114,2783,2783,1,0,0,0,1,3.59313
"76429",73391,344458,341644,467,561,34,2,1064,31.1435
"76430",351,9193,5953,3,0,0,0,3,5.03977
"76431",1161,26183,18922,10,0,1,1,12,6.34173
"76432",1985,83240,28810,12,0,0,0,12,4.16529
"76433",5717,121952,81625,39,0,0,0,39,4.77793
"76434",7826,126086,85370,58,4,1,0,63,7.37962
"76435",7725,120016,88652,65,0,5,0,70,7.89604
"76436",4754,210799,84975,40,0,0,0,40,4.70726
"76437",8114,103211,103211,62,0,0,0,62,6.00714
"76438",1935,28571,19939,15,0,0,0,15,7.52299
"76439",958,11794,11794,8,0,0,0,8,6.78304
"76440",1437,37780,19958,11,0,0,0,11,5.51146
"76441",4678,37200,37200,30,0,3,0,33,8.8709
"76442",4874,59575,59575,40,0,2,0,42,7.04995
"76443",2483,49017,35470,18,0,0,0,18,5.07472
"76445",3677,60056,47135,27,0,0,0,27,5.72818
"76446",2676,26034,26034,16,0,0,0,16,6.14591
"76447",55385,377993,342309,145,345,37,2,529,15.4539
"76448",8076,56363,54367,75,0,0,1,76,13.9791
"76449",5147,79540,63999,36,0,0,0,36,5.62507
"76450",639,7453,7453,6,0,0,0,6,8.05071
"76451",70050,359900,269333,93,195,91,2,381,14.146
"76452",25304,205246,205246,182,51,5,0,238,11.5958
"76453",4746,57709,57709,32,0,1,0,33,5.71839
"76454",4492,208938,33686,4,0,3,0,7,2.07804
"76455",2544,37029,37029,22,0,0,0,22,5.94133
"76456",3288,38438,38438,28,0,1,0,29,7.54471
"76457",4730,48680,41800,42,12,0,0,54,12.9188
"76458",866,19127,14432,8,0,0,0,8,5.54308
"76459",1471,23405,23405,8,0,3,0,11,4.69979
"76460",1638,27004,26184,14,0,1,0,15,5.7286
"76461",5709,144394,76787,36,0,1,0,37,4.81855
"76462",37076,209624,209624,85,132,40,3,260,12.4032
"76463",2253,34443,30494,16,2,0,0,18,5.90284
"76464",26122,320400,220438,161,15,2,0,178,8.07485
"76465",1810,57692,27447,16,0,0,0,16,5.82937
"76467",7484,81944,81944,72,0,0,0,72,8.78645
"76468",11646,136318,114370,96,1,4,0,101,8.83101
"76469",4196,62990,62990,37,0,0,0,37,5.87394
"76470",4406,59999,56414,42,0,0,0,42,7.44499
"76471",4499,63869,63869,36,0,2,0,38,5.94967
"76472",5688,83217,83217,49,0,0,0,49,5.8882
"76473",10135,253704,140888,52,3,3,0,58,4.11674
"76474",27330,127980,127980,111,290,10,2,413,32.2707
"76475",72279,373086,362943,396,225,37,0,658,18.1296
"76476",61783,430052,430052,404,75,23,1,503,11.6963
"76477",2365,35681,34262,13,2,0,0,15,4.37808
"76478",1201,25431,20849,12,0,0,0,12,5.75563
"76479",877,9415,9415,9,0,0,0,9,9.55961
"76480",1751,27836,27836,14,0,0,0,14,5.02954
"76481",68264,560724,540093,325,52,18,0,395,7.31355
"76482",9514,150798,99361,48,0,14,0,62,6.23985
"76483",3613,66609,66609,30,0,1,0,31,4.65399
"76484",75394,702620,646014,250,124,12,0,386,5.9751
"76485",1322,14996,14996,6,0,3,0,9,6.00176
"76486",522,4269,4269,5,2,0,0,7,16.3985
"76487",1250,57434,21593,14,0,0,0,14,6.4837
"76488",4493,124537,50155,29,0,1,0,30,5.98142
"76489",101979,322007,321212,32,0,9,1,42,1.30755
"76490",8514,143395,121337,61,8,2,0,71,5.85148
"76491",6695,137933,117119,46,0,1,0,47,4.01301
"76492",216,2896,2896,2,0,0,0,2,6.90634
"76493",3769,155395,59815,24,1,2,0,27,4.51389
"76494",4952,96500,61187,35,0,0,0,35,5.72014
"76495",33930,296527,236997,227,126,10,2,365,15.401
"76497",24071,91692,91692,131,342,17,2,492,53.6578
"76498",100661,342554,296422,162,844,53,6,1065,35.9285
"76499",8997,146839,94646,75,0,2,0,77,8.13558
"76500",2902,62518,31179,16,0,1,0,17,5.45232
"76501",1439,35613,25838,11,0,0,0,11,4.25733
"76502",3185,48048,33271,27,0,0,0,27,8.11506
"76503",7044,62089,59478,33,0,4,0,37,6.22077
"76504",633,9009,9009,7,0,0,0,7,7.77003
"76505",537,22315,13690,6,0,0,0,6,4.38267
"76506",3871,46616,46617,25,0,1,0,26,5.57742
"76507",4492,58546,32110,22,0,2,0,24,7.47442
"76508",4451,63806,46554,19,0,0,0,19,4.0813
"76509",14967,163957,149520,67,0,9,0,76,5.08294
"76510",1896,36710,36710,16,0,0,0,16,4.35854
"76511",314,7286,7286,3,0,0,0,3,4.11741
"76512",796,4354,4354,2,0,0,0,2,4.59389
"76513",980,14686,13203,6,2,0,0,8,6.05935
"76514",3471,35427,33271,29,0,3,0,32,9.61812
"76515",4165,41955,41955,32,4,1,0,37,8.819
"76516",3185,47180,29891,13,0,1,0,14,4.68368
"76517",19110,284934,156384,100,3,5,0,108,6.90608
"76518",2531,33057,33057,19,0,0,0,19,5.74767
"76519",146,11853,7785,2,0,0,0,2,2.56896
"76520",3341,46295,46295,23,0,2,0,25,5.40013
"76521",1320,23281,23281,9,0,0,0,9,3.86577
"76522",8605,166765,92893,56,0,0,0,56,6.02844
"76523",1052,15156,15156,9,0,0,0,9,5.93821
"76524",293,3383,3383,3,0,0,0,3,8.86776
"76526",785,10354,10354,9,0,0,0,9,8.69219
"76527",1876,26229,22567,16,0,0,0,16,7.09001
"76528",5784,68529,68529,35,0,1,0,36,5.25325
"76529",2199,41532,36899,22,0,0,0,22,5.96222
"76530",1081,19788,19788,8,0,0,0,8,4.04285
"76531",3581,46215,42078,18,0,0,0,18,4.27779
"76532",6339,73923,64661,45,0,1,0,46,7.11403
"76533",16699,137225,137225,14,0,11,3,28,2.04044
"76534",2259,31065,20236,12,12,0,0,24,11.86
"76535",5032,119119,69196,22,0,2,0,24,3.46839
"76536",4249,31640,31640,38,3,0,0,41,12.9582
"76537",850,15852,15852,7,0,1,0,8,5.0468
"76538",1492,52680,45649,13,0,0,0,13,2.84783
"76540",290112,653722,650749,225,5958,372,20,6575,101.037
"76541",14620,110581,110581,75,2,11,0,88,7.95799
"76542",1812,26068,26068,12,0,0,0,12,4.60334
"76543",5398,85773,78124,36,3,0,0,39,4.99206
"76544",1497,30143,28160,16,0,0,0,16,5.68186
"76545",29345,284982,239969,108,57,20,2,187,7.79269
"76546",1936,26703,26703,17,0,0,0,17,6.36641
"76547",16479,223258,163618,115,0,6,0,121,7.39526
"76548",7598,46607,46607,58,1,2,0,61,13.0881
"76549",730,16890,16890,7,0,1,0,8,4.73653
"76550",7533,159690,63959,47,0,7,0,54,8.4429
"76551",3942,53606,53606,20,0,1,1,22,4.10403
"76552",10930,45342,45342,51,166,9,0,226,49.8433
"76553",1341,28329,21119,12,0,0,0,12,5.68215
"76554",1000,19380,17040,9,0,0,0,9,5.28181
"76555",4674,61566,59440,34,0,0,0,34,5.72007
"76556",5376,145571,92477,48,4,0,0,52,5.62305
"76557",6376,161610,103035,48,1,6,0,55,5.33802
"76558",2631,38234,37603,27,0,1,0,28,7.4462
"76559",3184,48252,44968,30,0,0,0,30,6.67141
"76560",8166,63368,59713,58,0,3,0,61,10.2156
"76561",48687,282122,217563,94,227,25,3,349,16.0413
"76562",6440,106268,63855,42,0,9,0,51,7.98687
"76563",10742,126908,123727,62,0,1,0,63,5.09185
"76564",482,5732,5732,4,0,0,0,4,6.97847
"76565",15078,226862,121286,43,21,15,0,79,6.51351
"76566",1589,31479,31479,12,12,0,0,24,7.62412
"76567",1720,43194,33405,6,0,0,0,6,1.79613
"76568",6568,84465,68758,53,0,2,0,55,7.99908
"76569",1697,44667,29808,8,0,0,0,8,2.68383
"76570",6659,45629,45629,11,0,1,0,12,2.62993
"76571",4969,77011,75872,32,2,0,0,34,4.48122
"76573",1179,32228,22928,8,0,0,0,8,3.48926
"76574",9235,158696,128657,80,0,1,0,81,6.2958
"76575",173762,845101,843005,594,1332,72,7,2005,23.784
"76576",2315,40504,34704,10,0,1,0,11,3.16966
"76577",5465,82216,71336,48,0,1,0,49,6.86895
"76578",444,8902,8902,2,0,0,0,2,2.2466
"76580",6565,114642,79391,42,0,1,0,43,5.41626
"76581",3221,52516,43645,19,0,0,0,19,4.35331
"76582",2581,53031,33956,17,1,1,0,19,5.5954
"76583",4967,66223,62122,43,0,0,0,43,6.92181
"76584",556,4608,4609,5,0,0,0,5,10.8495
"76585",5304,85472,69395,39,0,1,0,40,5.76411
"76586",3299,80852,38999,22,0,0,0,22,5.64113
"76587",3262,55998,55998,24,0,0,0,24,4.28584
"76588",1872,33487,33487,21,0,1,0,22,6.5697
"76589",1424,21219,21219,12,0,0,0,12,5.65535
"76590",2337,31089,30037,18,0,0,0,18,5.99259
"76591",21996,233418,159426,93,5,29,0,127,7.96607
"76592",70512,185321,178183,15,0,4,0,19,1.06632
"76593",10038,102081,91229,26,0,8,0,34,3.72687
"76594",31451,315535,202570,48,0,54,1,103,5.08466
"76595",9154,162492,133253,60,0,7,1,68,5.10306
"76596",7448,62555,62555,63,0,0,0,63,10.0712
"76597",5778,80277,70277,22,10,4,0,36,5.12261
"76598",6716,76564,58375,30,0,2,0,32,5.48183
"76599",16451,90475,90475,108,59,3,0,170,18.7898
"76600",38761,565684,283845,59,14,41,0,114,4.01628
"76602",9804,211337,122947,47,0,5,1,53,4.31082
"76603",3419,57096,57096,21,0,0,0,21,3.67802
"76604",1061,44354,26007,11,0,0,0,11,4.22965
"76605",3993,56693,48579,28,0,2,0,30,6.17551
"76606",910,8831,8831,7,0,0,0,7,7.92637
"76608",21400,295146,199546,153,0,1,1,155,7.76762
"76609",4692,63558,49162,29,0,2,0,31,6.3057
"76610",15875,158257,133213,40,5,38,0,83,6.23061
"76611",2480,36863,36863,16,0,0,0,16,4.34035
"76612",1456,51845,35363,16,0,1,0,17,4.80724
"76613",3358,50209,47797,27,2,0,0,29,6.06728
"76614",9330,177784,90663,43,1,2,0,46,5.07373
"76615",1194,35689,18887,11,0,0,0,11,5.82415
"76616",7887,85775,72035,46,0,3,0,49,6.80228
"76617",7390,86468,52980,27,0,5,1,33,6.22881
"76618",94503,984182,885365,727,37,35,0,799,9.02453
"76619",2374,73444,40162,12,0,0,0,12,2.98791
"76620",3882,101533,45629,20,0,1,0,21,4.60236
"76621",9561,162012,134600,69,0,5,0,74,5.49779
"76622",1748,30080,30080,9,0,1,0,10,3.3245
"76623",293,3581,3581,2,0,0,0,2,5.58472
"76624",19120,138675,133019,112,0,13,0,125,9.39715
"76626",2003,41560,33314,17,0,0,0,17,5.10301
"76627",12578,264610,147009,90,0,3,0,93,6.32613
"76628",5534,55173,55173,42,0,1,0,43,7.79369
"76629",3075,49666,49666,27,0,0,0,27,5.43627
"76630",1365,30958,27108,11,0,0,0,11,4.05782
"76631",7551,69062,69062,68,0,1,0,69,9.991
"76632",3946,77967,56030,15,0,5,0,20,3.56949
"76634",7635,78803,70249,40,0,0,1,41,5.8364
"76636",16281,150506,136267,112,14,3,0,129,9.46669
"76637",3156,36356,36356,43,1,2,0,46,12.6527
"76638",6368,87763,58361,46,0,4,0,50,8.56736
"76640",44444,278031,211701,175,41,17,0,233,11.0061
"76641",258,3411,3410,4,0,0,0,4,11.7286
"76642",743,9038,9038,10,0,0,0,10,11.0649
"76644",4435,37105,37105,35,3,1,0,39,10.5107
"76645",1167,21458,21458,10,0,0,0,10,4.66023
"76646",3196,37435,30632,23,0,1,0,24,7.83499
"76647",15442,134086,125712,71,106,13,1,191,15.1934
"76648",19529,157471,124096,36,17,14,0,67,5.39905
"76649",5760,93478,80017,49,3,1,0,53,6.62362
"76650",4537,88791,83539,27,0,0,0,27,3.232
"76651",524,5142,5142,4,0,0,0,4,7.77921
"76652",5826,89203,70994,47,0,1,1,49,6.90197
"76653",2547,42132,42132,19,4,0,0,23,5.459
"76654",5414,80359,80359,43,0,0,0,43,5.35098
"76655",12736,85401,82924,66,209,10,0,285,34.3688
"76656",4435,45771,34093,51,7,1,0,59,17.3056
"76657",129329,456303,437788,72,0,16,0,88,2.01011
"76658",4622,54436,54436,35,0,0,0,35,6.42958
"76660",48459,177779,175547,28,12,20,1,61,3.47484
"76662",939,18380,18381,6,0,0,0,6,3.26433
"76663",4675,66809,45745,36,9,2,0,47,10.2743
"76664",5022,59803,59803,8,0,7,0,15,2.50823
"76665",1872,34458,27515,15,0,0,0,15,5.45157
"76666",2666,63697,63698,14,0,4,0,18,2.82585
"76667",1179,38906,27031,8,0,0,0,8,2.95961
"76668",2040,22807,22807,13,0,0,0,13,5.70011
"76669",2807,33792,33793,20,0,0,0,20,5.91846
"76670",6906,65186,65186,50,0,0,0,50,7.6703
"76671",626,6888,6888,7,0,0,0,7,10.1619
"76672",3090,37197,37197,19,3,3,0,25,6.72092
"76673",4801,277272,62341,44,0,0,0,44,7.05797
"76674",3272,66334,55328,31,0,0,0,31,5.60292
"76675",8225,89337,86345,65,0,2,0,67,7.75959
"76676",4489,91183,62690,37,0,1,0,38,6.06154
"76677",4327,69995,59257,29,4,0,0,33,5.56898
"76678",9362,215360,125111,64,2,3,0,69,5.51509
"76679",1353,34026,30316,6,0,0,0,6,1.97918
"76680",995,25223,18227,8,0,1,0,9,4.93771
"76681",52205,267817,202556,133,569,37,6,745,36.78
"76682",5922,50347,48995,49,0,0,0,49,10.0011
"76683",3249,52381,42161,21,0,3,0,24,5.6924
"76684",9184,58074,58074,42,8,2,0,52,8.95402
"76685",4836,59389,59389,45,0,2,0,47,7.91391
"76686",6392,60316,60316,44,5,3,0,52,8.62123
"76688",5454,85183,85183,31,3,2,1,37,4.34358
"76689",8942,104638,91372,11,0,6,2,19,2.07941
"76690",4115,49956,49956,36,0,0,0,36,7.2064
"76691",2928,52411,49941,20,0,1,0,21,4.20496
"76692",1442,47726,18363,12,3,0,0,15,8.16848
"76693",8397,89183,89183,33,0,3,0,36,4.03663
"76694",1260,18492,18492,11,0,0,0,11,5.94843
"76695",3357,42932,29756,19,0,3,0,22,7.39353
"76697",3862,39322,39322,35,0,1,0,36,9.15528
"76698",2711,27888,27888,18,0,1,0,19,6.81302
"76699",5023,100445,71628,41,0,0,0,41,5.72402
"76700",12581,146402,146402,98,28,11,0,137,9.35779
"76702",4515,151852,61849,37,0,1,0,38,6.14402
"76703",501,18469,7094,5,0,0,0,5,7.04797
"76705",45857,211980,188701,125,16,19,1,161,8.53202
"76706",1980,28931,20778,20,2,0,0,22,10.5882
"76707",7457,65137,65137,59,0,1,0,60,9.21135
"76708",6361,73930,63188,36,0,3,0,39,6.1721
"76709",24368,126454,119838,53,129,16,0,198,16.5223
"76710",333,5563,5563,2,0,0,0,2,3.59535
"76711",19394,121493,98071,76,169,29,0,274,27.939
"76712",6290,56346,56346,57,0,0,0,57,10.1161
"76714",4048,51998,47646,26,0,0,0,26,5.45697
"76715",9166,101488,97684,33,0,6,0,39,3.99249
"76716",4747,91861,49688,43,3,0,1,47,9.45897
"76717",176,5298,3622,1,0,1,0,2,5.52179
"76718",16851,224041,161953,81,13,15,0,109,6.73036
"76719",2185,44716,32465,12,12,3,0,27,8.31653
"76720",9093,288588,166534,60,2,3,0,65,3.9031
"76721",2873,75541,49094,15,0,1,0,16,3.25903
"76723",3094,51283,49667,29,0,0,0,29,5.83883
"76724",1266,23011,23011,10,0,0,0,10,4.34572
"76725",4066,54482,54482,24,0,0,0,24,4.40516
"76726",2840,62715,43233,26,0,0,0,26,6.0139
"76727",8716,175133,151929,68,0,1,0,69,4.5416
"76728",10960,79132,78501,23,0,15,0,38,4.84069
"76729",3093,34173,34173,26,0,0,0,26,7.60828
"76730",777,15734,15734,9,0,0,0,9,5.72006
"76731",1489,21749,21749,14,0,0,0,14,6.43719
"76732",902,13688,13688,9,0,0,0,9,6.57513
"76733",744,10562,10562,6,0,0,0,6,5.68052
"76734",3158,64631,49711,20,0,0,0,20,4.02326
"76735",2672,42408,39616,18,4,1,0,23,5.80566
"76736",1940,20114,18783,23,0,1,0,24,12.7776
"76737",3328,54306,51042,24,0,1,0,25,4.89794
"76738",18586,113401,113401,33,6,2,0,41,3.6155
"76739",2184,29282,29282,14,0,1,0,15,5.12263
"76740",4918,60878,60878,38,0,3,0,41,6.73474
"76741",2025,44313,43774,12,0,1,0,13,2.96982
"76743",8875,106525,79155,68,0,2,1,71,8.96971
"76744",1688,24782,24782,13,0,0,0,13,5.2458
"76745",2513,24302,24303,18,0,1,0,19,7.81812
"76746",253,6789,6789,3,0,0,0,3,4.41871
"76747",3965,66111,38304,24,0,0,0,24,6.26568
"76748",2693,43245,43245,22,0,2,0,24,5.54973
"76749",1146,15024,15024,8,0,1,0,9,5.99045
"76750",4105,53781,41227,14,8,9,0,31,7.51943
"76751",5823,70068,70068,34,4,4,0,42,5.99418
"76752",23156,248256,204864,102,15,25,1,143,6.98025
"76753",7796,55240,53368,70,4,0,0,74,13.8659
"76754",578,6577,6577,5,23,2,0,30,45.6153
"76755",4184,72535,62088,33,0,1,0,34,5.4761
"76756",1709,16464,16464,8,0,0,0,8,4.85907
"76757",2921,50280,42793,24,0,1,0,25,5.84214
"76758",95481,492236,487103,445,627,44,0,1116,22.911
"76759",2787,43488,43488,21,0,1,0,22,5.05887
